player_id,Player Name,Team,Position,Games,G,A,Points,+/-,PIM,SOG,GWG,PPG,PPA,PPP,BS,Hits,SHG,SHA
8478402,Connor McDavid,EDM,C,78,41,75,116,3,20,240,9,9,24,33,30,39,1,1
8474141,Patrick Kane,CHI,RW,81,44,66,110,2,22,341,7,9,21,30,18,21,0,0
8477934,Leon Draisaitl,EDM,C,82,50,55,105,2,52,231,5,16,13,29,26,57,3,0
8473419,Brad Marchand,BOS,LW,79,36,64,100,15,96,231,9,10,24,34,19,46,3,4
8471675,Sidney Crosby,PIT,C,79,35,65,100,18,36,220,3,12,17,29,43,85,0,2
8477492,Nathan MacKinnon,COL,C,82,41,58,99,20,34,365,6,12,25,37,31,54,0,0
8476346,Johnny Gaudreau,CGY,LW,82,36,63,99,18,24,245,8,6,21,27,12,12,0,0
8474564,Steven Stamkos,TBL,C,82,45,53,98,4,37,234,6,19,21,40,40,72,2,0
8477493,Aleksander Barkov,FLA,C,82,35,61,96,-3,8,206,5,13,18,31,61,28,0,1
8478483,Mitchell Marner,TOR,RW,82,26,68,94,22,22,233,5,3,18,21,43,29,1,2
8478010,Brayden Point,TBL,C,79,41,51,92,27,28,191,7,20,15,35,43,31,0,0
8476456,Jonathan Huberdeau,FLA,LW,82,30,62,92,-14,40,226,5,11,23,34,45,57,0,0
8471218,Blake Wheeler,WPG,RW,82,20,71,91,0,60,231,3,2,31,33,53,81,2,1
8471214,Alex Ovechkin,WSH,LW,81,51,38,89,7,40,338,5,18,10,28,41,223,0,0
8475166,John Tavares,TOR,C,82,47,41,88,19,34,286,8,10,9,19,53,59,0,0
8478420,Mikko Rantanen,COL,RW,74,31,56,87,13,54,193,4,16,17,33,41,59,0,0
8478550,Artemi Panarin,NYR,LW,79,28,59,87,14,23,191,8,6,12,18,17,14,0,0
8473512,Claude Giroux,PHI,C,82,22,63,85,9,24,229,4,2,21,23,19,28,1,0
8476460,Mark Scheifele,WPG,C,82,38,46,84,8,38,199,6,12,11,23,54,54,0,3
8470613,Brent Burns,SJS,D,82,16,67,83,13,34,300,6,7,21,28,105,90,1,4
8478427,Sebastian Aho,CAR,C,82,30,53,83,25,26,243,7,3,21,24,34,65,4,1
8478403,Jack Eichel,BUF,C,77,28,54,82,-11,26,303,2,8,18,26,51,70,0,0
8473548,Phil Kessel,ARI,RW,82,27,55,82,-19,28,215,10,12,24,36,18,12,0,0
8477497,Sean Monahan,CGY,C,78,34,48,82,7,12,211,5,12,11,23,24,36,0,0
8477956,David Pastrnak,BOS,RW,66,38,43,81,6,32,235,4,17,16,33,25,57,0,0
8473604,Jonathan Toews,CHI,C,82,35,46,81,2,40,235,5,9,14,23,44,42,1,0
8475794,Tyler Seguin,DAL,C,82,33,47,80,17,18,334,8,9,18,27,47,74,0,0
8470638,Patrice Bergeron,BOS,C,65,32,47,79,23,30,205,3,9,18,27,60,43,4,3
8477496,Elias Lindholm,CGY,C,81,27,51,78,30,20,182,5,9,17,26,39,82,1,3
8475158,Ryan O'Reilly,STL,C,82,28,49,77,22,12,234,5,6,16,22,36,31,1,2
8479314,Matthew Tkachuk,CGY,LW,80,34,43,77,14,62,207,2,11,13,24,13,104,0,0
8476882,Teuvo Teravainen,CAR,LW,82,21,55,76,30,12,167,1,8,16,24,23,35,1,4
8477404,Jake Guentzel,PIT,LW,82,40,36,76,13,26,227,4,6,5,11,47,105,1,0
8476461,Sean Couturier,PHI,C,80,33,43,76,2,34,223,5,8,9,17,60,40,1,0
8479337,Alex DeBrincat,CHI,LW,82,41,35,76,0,15,220,3,13,11,24,26,35,0,0
8476455,Gabriel Landeskog,COL,LW,73,34,41,75,17,51,243,9,10,17,27,64,120,0,0
8476459,Mika Zibanejad,NYR,C,82,30,44,74,-12,47,236,5,11,12,23,66,134,2,0
8476881,Tomas Hertl,SJS,C,77,35,39,74,5,18,176,5,11,4,15,64,53,1,1
8473563,Nicklas Backstrom,WSH,C,80,22,52,74,2,30,169,5,7,18,25,30,54,0,0
8470966,Mark Giordano,CGY,D,78,17,57,74,39,69,221,2,3,18,21,144,58,4,2
8477946,Dylan Larkin,DET,C,76,32,41,73,-6,75,287,4,7,8,15,38,80,2,1
8471276,David Krejci,BOS,C,81,20,53,73,7,16,139,4,6,10,16,24,28,0,0
8475913,Mark Stone,VGK,RW,77,33,40,73,17,27,199,4,6,14,20,71,72,1,0
8479318,Auston Matthews,TOR,C,68,37,36,73,-9,12,251,5,12,8,20,60,28,0,0
8475744,Evgeny Kuznetsov,WSH,C,76,21,51,72,7,50,193,3,8,15,23,20,46,0,0
8477503,Max Domi,CBJ,C,82,28,44,72,20,80,203,2,4,7,11,39,53,0,0
8471215,Evgeni Malkin,PIT,C,68,21,51,72,-25,89,187,5,9,17,26,33,54,0,0
8476853,Morgan Rielly,TOR,D,82,20,52,72,24,14,223,5,3,18,21,114,61,0,0
8471228,Alexander Radulov,DAL,RW,70,29,43,72,22,54,209,7,7,16,23,83,60,0,0
8474884,Mike Hoffman,STL,C,82,36,34,70,-24,30,253,6,17,18,35,26,42,0,0
8475168,Matt Duchene,NSH,C,73,31,39,70,-3,8,172,1,6,8,14,40,28,0,0
8474149,Evgenii Dadonov,OTT,RW,82,28,42,70,-6,8,195,4,8,9,17,42,33,0,0
8474590,John Carlson,WSH,D,80,13,57,70,21,34,185,1,3,30,33,164,54,0,0
8474053,Logan Couture,SJS,C,81,27,43,70,-6,22,204,3,6,12,18,52,65,2,0
8474715,Cam Atkinson,CBJ,RW,80,41,28,69,3,20,295,8,8,6,14,25,27,4,0
8476454,Ryan Nugent-Hopkins,EDM,C,82,28,41,69,-13,26,208,3,8,18,26,40,69,1,2
8478414,Timo Meier,SJS,RW,78,30,36,66,9,55,250,2,6,4,10,40,99,0,1
8478398,Kyle Connor,WPG,LW,82,34,32,66,-7,18,227,5,11,8,19,21,9,1,0
8474161,Jakub Voracek,PHI,RW,78,20,46,66,-16,25,210,2,4,14,18,29,17,0,0
8480012,Elias Pettersson,VAN,C,71,28,38,66,3,12,144,7,10,12,22,51,42,0,0
8477933,Sam Reinhart,BUF,RW,82,22,43,65,-10,16,180,1,2,13,15,47,38,0,0
8470794,Joe Pavelski,DAL,C,75,38,26,64,-4,22,188,6,12,9,21,61,69,1,0
8475793,Ryan Johansen,NSH,C,80,14,50,64,7,42,136,6,0,16,16,23,95,1,1
8475784,Jeff Skinner,BUF,LW,82,40,23,63,0,36,268,7,8,8,16,24,31,0,0
8471735,Keith Yandle,FLA,D,82,9,53,62,-17,50,199,2,7,32,39,76,47,0,0
8478445,Mathew Barzal,NYI,C,82,18,44,62,-5,46,179,3,3,15,18,56,25,0,0
8479400,Pierre-Luc Dubois,WPG,LW,82,27,34,61,16,64,174,5,2,7,9,52,115,0,0
8477500,Bo Horvat,VAN,C,82,27,34,61,-4,33,227,3,7,11,18,63,62,2,1
8470610,Zach Parise,MIN,LW,74,28,33,61,-2,26,229,5,10,6,16,71,49,0,2
8476979,Erik Gustafsson,PHI,D,79,17,43,60,-6,34,160,3,4,14,18,115,100,0,0
8471685,Anze Kopitar,LAK,C,81,22,38,60,-20,30,156,3,1,18,19,66,59,2,0
8475197,Tyson Barrie,EDM,D,78,14,45,59,-3,36,218,2,2,23,25,93,48,0,0
8476539,Jonathan Marchessault,VGK,C,82,25,34,59,2,52,278,6,5,11,16,22,98,0,0
8475193,Tomas Tatar,MTL,LW,80,25,33,58,21,34,195,4,4,4,8,30,77,0,0
8478440,Dylan Strome,CHI,C,78,20,37,57,-8,20,145,3,6,10,16,46,13,0,0
8474600,Roman Josi,NSH,D,82,15,41,56,9,42,274,4,2,10,12,144,53,0,1
8474573,Josh Bailey,NYI,RW,82,16,40,56,8,21,126,4,2,12,14,32,19,1,0
8471724,Kris Letang,PIT,D,65,16,40,56,13,48,206,3,2,17,19,111,116,1,1
8476288,Ryan Dzingel,CAR,C,78,26,30,56,-9,29,159,5,5,6,11,38,54,0,0
8478444,Brock Boeser,VAN,RW,69,26,30,56,-2,22,209,3,6,9,15,22,14,0,0
8476448,William Karlsson,VGK,C,82,24,32,56,1,16,169,5,7,7,14,55,51,1,2
8478099,Kevin Labanc,SJS,RW,82,17,39,56,-1,36,130,4,2,18,20,16,66,0,0
8475169,Evander Kane,SJS,LW,75,30,26,56,-4,153,268,1,5,6,11,25,173,1,1
8478469,Thomas Chabot,OTT,D,70,14,41,55,-12,32,185,2,1,15,16,112,71,1,0
8475763,Kevin Hayes,PHI,C,71,19,36,55,-2,12,156,2,3,8,11,15,58,2,1
8475798,Mikael Granlund,NSH,C,79,16,38,54,-8,24,189,5,2,18,20,40,46,2,0
8475170,Brayden Schenn,STL,C,72,17,37,54,3,40,159,5,4,8,12,31,111,0,0
8471698,T.J. Oshie,WSH,RW,69,25,29,54,5,36,143,4,6,8,14,55,133,1,0
8475167,Victor Hedman,TBL,D,70,12,42,54,24,44,182,4,2,23,25,97,59,0,1
8476792,Torey Krug,STL,D,64,6,47,53,-2,33,151,2,2,28,30,60,53,0,0
8475754,Brock Nelson,NYI,C,82,25,28,53,20,28,181,3,2,6,8,55,51,1,0
8473994,Jamie Benn,DAL,LW,78,27,26,53,14,56,189,2,8,3,11,71,142,0,0
8476479,Phillip Danault,MTL,C,81,12,41,53,17,39,132,1,0,4,4,60,95,0,2
8475799,Nino Niederreiter,CAR,RW,82,23,30,53,-4,30,184,3,6,9,15,20,94,0,0
8475191,Reilly Smith,VGK,RW,74,19,34,53,13,14,178,1,4,10,14,33,39,1,3
8477494,Jonathan Drouin,MTL,LW,81,18,35,53,-8,26,190,3,3,13,16,23,55,0,0
8475184,Chris Kreider,NYR,LW,79,28,24,52,4,57,201,2,7,5,12,49,159,0,0
8470595,Eric Staal,BUF,C,81,22,30,52,-7,34,215,6,7,8,15,28,41,0,1
8477949,Alex Tuch,VGK,RW,74,20,32,52,13,8,180,6,3,3,6,40,92,0,0
8475848,Brendan Gallagher,MTL,RW,82,33,19,52,10,49,302,4,4,3,7,31,126,0,0
8470606,Dustin Brown,LAK,RW,72,22,29,51,-17,24,180,3,9,3,12,29,150,1,1
8475314,Anders Lee,NYI,LW,82,28,23,51,20,58,204,5,10,6,16,51,103,0,0
8466138,Joe Thornton,TOR,C,73,16,35,51,8,20,90,4,3,12,15,14,17,0,0
8475151,Kyle Palmieri,NJD,RW,74,27,23,50,-9,42,224,2,11,7,18,35,98,0,0
8479339,Patrik Laine,CBJ,RW,82,30,20,50,-24,42,245,3,15,8,23,44,70,0,0
8476887,Filip Forsberg,NSH,LW,64,28,22,50,8,26,217,4,7,3,10,29,100,2,0
8476885,Jacob Trouba,NYR,D,82,8,42,50,8,58,162,1,3,15,18,171,112,1,2
8471262,Carl Soderberg,CHI,C,82,23,26,49,-5,26,188,2,2,8,10,67,99,3,0
8478439,Travis Konecny,PHI,RW,82,24,25,49,-4,40,182,3,4,4,8,45,65,0,0
8474037,James van Riemsdyk,PHI,LW,66,27,21,48,-10,18,167,4,8,5,13,16,34,0,0
8478042,Viktor Arvidsson,NSH,RW,58,34,14,48,12,26,195,7,3,1,4,23,18,2,1
8470612,Ryan Getzlaf,ANA,C,67,14,34,48,-19,58,133,2,1,10,11,74,150,0,0
8477511,Anthony Mantha,DET,RW,67,25,23,48,-8,30,198,1,7,6,13,23,67,0,0
8476826,Yanni Gourde,TBL,C,80,22,26,48,9,66,130,5,5,4,9,30,83,1,1
8476919,Chris Tierney,OTT,C,81,9,39,48,-22,26,116,1,0,10,10,54,30,0,0
8474150,Mikael Backlund,CGY,C,77,21,26,47,34,52,205,4,1,1,2,26,52,1,1
8476438,Brandon Saad,COL,LW,80,23,24,47,-9,12,195,3,5,1,6,25,52,3,0
8479343,Clayton Keller,ARI,RW,82,14,33,47,-21,24,200,5,1,18,19,21,16,0,0
8477944,Jakub Vrana,WSH,LW,82,24,23,47,20,27,161,4,1,3,4,32,47,0,0
8477479,Tyler Bertuzzi,DET,LW,73,21,26,47,11,36,131,4,3,3,6,39,76,0,0
8474870,Tyler Johnson,TBL,C,80,29,18,47,15,28,163,4,1,7,8,32,50,1,0
8476981,Josh Anderson,MTL,RW,82,27,20,47,25,60,230,5,3,4,7,40,214,2,1
8476381,Andrew Shaw,CHI,RW,63,19,28,47,17,71,135,3,3,3,6,36,128,0,0
8476468,J.T. Miller,VAN,C,75,13,34,47,8,30,108,4,4,16,20,23,115,0,0
8470600,Ryan Suter,MIN,D,82,7,40,47,-8,41,136,2,3,12,15,109,78,1,1
8475792,Brett Connolly,FLA,RW,81,22,24,46,13,24,139,5,1,1,2,25,53,0,0
8474102,David Perron,STL,LW,57,23,23,46,3,46,112,1,7,7,14,13,52,0,0
8474151,Ryan McDonagh,TBL,D,82,9,37,46,38,34,128,1,0,3,3,161,98,0,3
8473507,Jeff Petry,MTL,D,82,13,33,46,-5,28,172,4,3,8,11,123,190,0,1
8477495,Seth Jones,CBJ,D,75,9,37,46,1,28,184,4,0,10,10,133,106,0,3
8480801,Brady Tkachuk,OTT,LW,71,22,23,45,-10,75,214,3,4,6,10,26,174,0,0
8475906,John Klingberg,DAL,D,64,10,35,45,6,12,153,5,5,15,20,77,42,0,0
8474578,Erik Karlsson,SJS,D,53,3,42,45,6,22,169,1,2,18,20,69,44,0,0
8474563,Drew Doughty,LAK,D,82,8,37,45,-34,44,154,1,7,17,24,120,168,0,1
8475172,Nazem Kadri,COL,C,73,16,28,44,-2,43,184,5,4,9,13,13,85,0,0
8480839,Rasmus Dahlin,BUF,D,82,9,35,44,-13,34,177,4,5,15,20,66,97,0,0
8475171,Oliver Ekman-Larsson,ARI,D,81,14,30,44,-16,52,176,2,5,14,19,52,162,1,2
8477953,Kasperi Kapanen,PIT,RW,78,20,24,44,12,27,174,3,1,2,3,19,92,2,0
8475218,Mattias Ekholm,NSH,D,80,8,36,44,27,47,146,3,2,5,7,107,68,0,2
8478460,Zach Werenski,CBJ,D,82,11,33,44,-12,18,168,1,2,13,15,89,67,0,0
8476483,Rickard Rakell,ANA,LW,69,18,25,43,-13,27,194,2,6,7,13,38,82,0,0
8474716,Jared Spurgeon,MIN,D,82,14,29,43,-1,20,152,0,4,7,11,145,91,0,1
8475164,Jakob Silfverberg,ANA,RW,73,24,19,43,-9,28,163,4,3,8,11,43,38,2,1
8477499,Rasmus Ristolainen,BUF,D,78,5,38,43,-41,38,182,2,1,16,17,121,235,0,0
8477341,Andreas Johnsson,NJD,LW,73,20,23,43,14,32,130,3,3,3,6,36,60,0,0
8471676,Bobby Ryan,DET,RW,78,15,27,42,-29,35,160,1,7,9,16,49,77,0,0
8478498,Jake DeBrusk,BOS,LW,68,27,15,42,2,18,156,4,8,3,11,24,45,0,0
8471669,Paul Stastny,WPG,C,50,13,29,42,14,30,103,2,1,3,4,15,35,1,1
8475722,Jason Zucker,PIT,LW,81,21,21,42,-9,28,214,5,7,7,14,38,87,0,0
8477021,Alexander Kerfoot,TOR,C,78,15,27,42,-9,38,116,1,4,12,16,29,22,0,0
8474641,Adam Henrique,ANA,C,82,18,24,42,-5,24,122,3,8,5,13,71,78,0,1
8478400,Colin White,OTT,C,71,14,27,41,-24,24,123,2,5,3,8,35,23,0,0
8477498,Darnell Nurse,EDM,D,82,10,31,41,-5,87,196,1,1,8,9,146,162,0,1
8475176,Ryan Ellis,NSH,D,82,7,34,41,21,20,149,2,1,4,5,154,71,1,0
8475786,Zach Hyman,TOR,LW,71,21,20,41,16,65,144,4,0,0,0,39,102,1,0
8476851,Alex Galchenyuk,OTT,LW,72,19,22,41,-19,34,159,4,9,12,21,34,62,0,0
8473412,Bryan Little,WPG,C,82,15,26,41,-12,26,126,5,4,3,7,29,62,0,2
8474565,Alex Pietrangelo,VGK,D,71,13,28,41,2,22,168,2,3,12,15,139,62,0,1
8475236,Cody Eakin,BUF,C,78,22,19,41,19,16,120,3,1,3,4,35,88,3,0
8476880,Tom Wilson,WSH,RW,63,22,18,40,11,128,130,2,3,2,5,52,200,2,0
8474157,Max Pacioretty,VGK,LW,66,22,18,40,-13,36,191,5,4,4,8,20,119,0,0
8473986,Alex Killorn,TBL,LW,82,18,22,40,22,45,153,2,2,3,5,23,88,1,1
8475692,Mats Zuccarello,MIN,RW,48,12,28,40,-8,24,104,1,3,12,15,43,57,0,0
8470281,Duncan Keith,CHI,D,82,6,34,40,13,70,141,1,0,3,3,144,42,0,1
8477942,Kevin Fiala,MIN,LW,83,13,26,39,-23,36,174,2,2,9,11,20,42,0,0
8478366,Frank Vatrano,FLA,C,81,24,15,39,-10,38,208,1,2,6,8,74,139,0,0
8476923,Damon Severson,NJD,D,82,11,28,39,-27,58,146,0,3,9,12,87,83,0,1
8476462,Dougie Hamilton,CAR,D,82,18,21,39,0,54,259,2,2,5,7,91,160,0,0
8476994,Vinnie Hinostroza,FLA,C,72,16,23,39,-4,14,152,3,3,2,5,41,69,0,0
8478519,Anthony Cirelli,TBL,C,82,19,20,39,25,34,123,5,0,1,1,49,94,5,1
8475098,Tyler Bozak,STL,C,72,13,25,38,-3,20,141,3,2,6,8,33,52,0,0
8476432,Boone Jenner,CBJ,C,77,16,22,38,6,42,170,3,1,2,3,70,158,1,0
8478585,Derek Ryan,CGY,C,81,13,25,38,21,24,103,1,2,5,7,19,19,0,4
8477402,Pavel Buchnevich,NYR,RW,64,21,17,38,-10,13,119,1,7,5,12,20,60,0,0
8475225,Craig Smith,BOS,C,76,21,17,38,11,20,205,2,4,4,8,33,77,0,0
8475163,Alex Chiasson,EDM,RW,73,22,16,38,-1,32,123,1,8,7,15,31,85,1,1
8480946,Dominik Kahun,EDM,C,82,13,24,37,10,6,137,2,1,1,2,27,13,0,0
8473573,Artem Anisimov,OTT,C,78,15,22,37,-2,14,142,1,1,3,4,33,25,1,0
8474586,Jordan Eberle,NYI,RW,78,19,18,37,-6,17,160,5,7,5,12,35,36,0,0
8466139,Patrick Marleau,SJS,C,82,16,21,37,-6,28,161,3,4,6,10,41,74,0,0
8475791,Taylor Hall,BUF,LW,33,11,26,37,-6,16,113,3,1,11,12,29,22,0,0
8474162,Jake Muzzin,TOR,D,80,9,28,37,21,47,141,1,1,4,5,134,172,0,1
8477506,Ryan Pulock,NYI,D,82,9,28,37,21,22,180,3,3,6,9,148,143,0,0
8477447,Shea Theodore,VGK,D,79,12,25,37,-4,20,202,1,4,5,9,91,27,0,1
8477932,Aaron Ekblad,FLA,D,82,13,24,37,1,47,180,1,5,5,10,88,114,0,0
8476906,Shayne Gostisbehere,PHI,D,78,9,28,37,-20,22,180,2,4,10,14,102,46,0,0
8477940,Nikolaj Ehlers,WPG,LW,62,21,16,37,2,15,158,4,2,5,7,16,27,0,0
8480830,Andrei Svechnikov,CAR,RW,82,20,17,37,0,62,189,3,0,5,5,26,123,0,0
8471887,Patric Hornqvist,FLA,RW,69,18,19,37,-3,26,197,2,6,6,12,34,150,0,0
8475820,Joonas Donskoi,COL,RW,80,14,23,37,10,10,115,4,1,2,3,36,36,0,0
8476399,Blake Coleman,TBL,C,78,22,14,36,-19,71,213,3,3,0,3,44,225,3,2
8475768,Jaden Schwartz,STL,LW,69,11,25,36,-6,16,183,1,2,3,5,27,61,0,0
8477416,Oliver Bjorkstrand,CBJ,RW,77,23,13,36,8,8,161,1,3,0,3,34,43,0,0
8474189,Lars Eller,WSH,C,81,13,23,36,-1,37,163,1,0,3,3,47,69,1,2
8474009,Nick Bonino,MIN,C,81,17,18,35,27,18,118,1,3,0,3,70,24,0,1
8474613,Derek Stepan,OTT,C,72,15,20,35,-2,14,195,3,1,2,3,51,50,3,0
8477986,Brandon Montour,BUF,D,82,8,27,35,-20,56,181,2,1,5,6,121,99,0,0
8477955,Jared McCann,PIT,C,78,19,16,35,-1,31,150,2,1,2,3,51,77,4,0
8475753,Justin Faulk,STL,D,82,11,24,35,9,47,217,3,6,4,10,121,156,0,0
8477948,Travis Sanheim,PHI,D,82,9,26,35,-4,22,121,2,2,3,5,133,45,0,0
8475810,Bryan Rust,PIT,RW,72,18,17,35,10,24,141,4,0,0,0,59,119,2,2
8478407,Vince Dunn,STL,D,78,12,23,35,14,45,150,4,3,5,8,68,48,0,0
8476918,Jimmy Vesey,TOR,LW,81,17,18,35,-6,21,154,4,1,3,4,34,79,0,0
8476458,Ryan Strome,NYR,C,81,19,16,35,-3,64,110,2,4,3,7,36,76,0,0
8473422,Nick Foligno,CBJ,LW,73,17,18,35,12,44,141,2,2,2,4,51,175,0,0
8470144,Frans Nielsen,DET,C,72,10,25,35,-7,14,120,4,0,8,8,44,79,0,1
8476389,Vincent Trocheck,CAR,C,55,10,24,34,-9,54,158,1,3,10,13,42,112,1,0
8471303,Alexander Edler,VAN,D,56,10,24,34,3,54,128,2,4,13,17,166,127,0,1
8480829,Jesperi Kotkaniemi,MTL,C,79,11,23,34,1,26,134,2,1,4,5,41,66,0,0
8477839,Conor Sheary,WSH,LW,78,14,20,34,-18,12,147,3,4,2,6,29,29,0,0
8475726,Tyler Toffoli,MTL,C,82,13,21,34,-16,23,226,3,3,2,5,23,39,0,0
8473564,Michael Frolik,MTL,RW,65,16,18,34,24,26,132,4,0,0,0,22,57,2,0
8474673,TJ Brodie,TOR,D,79,9,25,34,29,24,102,1,1,3,4,86,21,1,0
8476292,Ondrej Palat,TBL,LW,64,8,26,34,4,20,100,1,2,6,8,34,104,0,0
8475745,Charlie Coyle,BOS,C,81,12,22,34,-1,20,155,2,1,3,4,56,77,1,0
8478046,Danton Heinen,ANA,LW,77,11,23,34,13,16,114,2,1,6,7,36,54,0,0
8470604,Jeff Carter,LAK,C,76,13,20,33,-20,42,174,1,5,8,13,30,80,1,1
8480113,Alex Iafallo,LAK,LW,82,15,18,33,-17,22,148,2,2,4,6,54,87,0,0
8475209,Richard Panik,WSH,RW,75,14,19,33,-3,44,140,2,0,2,2,52,137,1,0
8478067,Oskar Lindblom,PHI,LW,81,17,16,33,-9,20,162,2,2,1,3,52,68,0,0
8475231,Casey Cizikas,NYI,C,73,20,13,33,22,36,111,3,0,0,0,68,129,2,1
8470642,Shea Weber,MTL,D,58,14,19,33,15,28,166,3,5,1,6,110,129,0,0
8477407,Anthony Duclair,FLA,LW,74,19,14,33,-2,14,132,3,7,1,8,33,32,0,0
8479407,Jesper Bratt,NJD,LW,51,8,25,33,-8,6,91,1,1,7,8,22,36,0,0
8480036,Miro Heiskanen,DAL,D,82,12,21,33,-14,16,182,4,2,6,8,71,34,0,1
8480023,Robert Thomas,STL,C,70,9,24,33,-2,14,80,0,3,4,7,22,13,0,0
8478396,Noah Hanifin,CGY,D,80,5,28,33,18,12,116,2,1,4,5,83,87,1,1
8476902,Esa Lindell,DAL,D,82,11,21,32,14,33,132,1,4,3,7,161,143,2,0
8476873,Mark Jankowski,PIT,C,79,14,18,32,6,12,99,1,0,0,0,56,30,5,3
8476872,Scott Laughton,PHI,C,82,12,20,32,-11,53,130,1,0,0,0,46,146,0,2
8479410,Mikhail Sergachev,TBL,D,75,6,26,32,12,28,128,0,0,6,6,93,97,0,0
8477456,J.T. Compher,COL,LW,66,16,16,32,-8,31,118,3,4,5,9,59,33,3,0
8474574,Tyler Myers,VAN,D,80,9,22,31,11,63,156,3,0,7,7,99,97,1,1
8470047,Valtteri Filppula,DET,C,72,17,14,31,19,16,78,4,0,0,0,34,12,1,0
8474849,Antoine Roussel,VAN,LW,65,9,22,31,5,118,84,1,0,0,0,50,87,0,0
8474056,P.K. Subban,NJD,D,63,9,22,31,5,60,168,1,2,8,10,75,56,1,0
8476958,Jaccob Slavin,CAR,D,82,8,23,31,0,18,146,1,5,2,7,133,70,1,1
8474038,Paul Byron,MTL,LW,56,15,16,31,16,17,94,3,0,1,1,36,114,2,1
8477476,Artturi Lehkonen,MTL,LW,82,11,20,31,10,32,176,4,0,0,0,39,120,0,0
8477504,Josh Morrissey,WPG,D,59,6,25,31,9,14,95,2,3,7,10,107,55,1,1
8477941,Nick Ritchie,BOS,LW,60,9,22,31,6,82,96,2,2,7,9,31,123,0,0
8476897,Oskar Sundqvist,STL,C,74,14,17,31,-1,22,113,2,0,1,1,31,101,1,1
8476480,Vladislav Namestnikov,DET,C,78,11,20,31,-7,44,119,3,1,2,3,62,140,2,3
8479974,Nolan Patrick,PHI,C,72,13,18,31,-8,27,115,3,1,1,2,26,72,0,0
8476889,Radek Faksa,DAL,C,81,15,15,30,-3,54,114,1,1,2,3,65,103,1,1
8477355,Will Butcher,NJD,D,78,4,26,30,-17,18,108,1,1,13,14,74,38,0,0
8474190,Wayne Simmonds,TOR,RW,79,17,13,30,-16,99,157,2,5,3,8,28,137,0,0
8473618,Mathieu Perreault,WPG,LW,82,15,15,30,-1,44,95,3,4,3,7,25,127,0,0
8476925,Colton Sissons,NSH,C,75,15,15,30,20,23,111,3,1,1,2,52,109,0,1
8475834,Marcus Sorensen,SJS,LW,80,17,13,30,10,23,100,1,0,0,0,29,88,1,1
8475149,Marcus Johansson,MIN,C,58,13,17,30,-16,8,115,1,2,7,9,24,28,0,0
8477220,Nate Schmidt,VAN,D,61,9,21,30,22,8,112,1,1,7,8,100,37,0,0
8474581,Jake Gardiner,CAR,D,62,3,27,30,19,26,78,0,0,5,5,64,61,0,0
8476913,Devin Shore,EDM,C,76,10,19,29,-12,13,82,4,2,3,5,64,94,2,0
8477488,Brett Pesce,CAR,D,73,7,22,29,35,24,98,2,0,0,0,131,53,0,2
8478542,Evan Rodrigues,PIT,C,74,9,20,29,-7,25,168,1,2,2,4,33,33,0,3
8479293,Brandon Tanev,PIT,LW,80,14,15,29,9,41,127,0,0,0,0,81,278,2,1
8470626,Loui Eriksson,VAN,LW,81,11,18,29,-11,22,107,2,1,2,3,28,3,0,0
8473449,Kyle Okposo,BUF,RW,78,14,15,29,-9,41,147,2,7,4,11,27,87,0,0
8475200,Dmitry Orlov,WSH,D,82,3,26,29,3,33,101,0,0,1,1,103,137,0,0
8476850,Ryan Murray,NJD,D,56,1,28,29,20,10,71,0,0,1,1,93,27,0,0
8477015,Connor Brown,OTT,RW,82,8,21,29,11,16,85,0,0,1,1,37,35,0,3
8476525,Colin Miller,BUF,D,65,3,26,29,0,44,131,0,1,12,13,64,122,0,0
8474034,Pat Maroon,TBL,LW,74,10,18,28,-3,64,118,3,2,9,11,7,135,0,0
8477960,Adrian Kempe,LAK,C,81,12,16,28,-10,50,118,2,0,4,4,21,86,0,0
8470607,Brent Seabrook,CHI,D,78,5,23,28,-6,41,165,1,2,8,10,180,124,0,1
8478027,Lucas Wallmark,CHI,C,81,10,18,28,-8,36,131,4,2,5,7,39,82,0,0
8473533,Jordan Staal,CAR,C,50,11,17,28,6,26,121,1,0,2,2,18,122,0,0
8474031,Kevin Shattenkirk,ANA,D,73,2,26,28,-15,20,148,0,1,6,7,104,73,0,0
8476854,Hampus Lindholm,ANA,D,76,6,22,28,-5,44,125,0,1,5,6,133,81,0,1
8478866,Dominik Simon,CGY,C,71,8,20,28,8,18,121,0,1,2,3,19,89,0,0
8474250,Zack Smith,CHI,C,70,9,19,28,-6,81,101,1,0,0,0,27,136,1,2
8476892,Colton Parayko,STL,D,80,10,18,28,20,15,176,3,4,4,8,157,127,0,1
8479325,Charlie McAvoy,BOS,D,54,7,21,28,14,45,79,3,1,1,2,91,92,0,1
8478463,Anthony Beauvillier,NYI,LW,81,18,10,28,1,8,156,4,1,1,2,35,87,0,0
8469455,Jason Spezza,TOR,C,76,8,19,27,-13,29,121,1,2,10,12,30,16,0,0
8476875,Mike Matheson,PIT,D,75,8,19,27,-24,44,129,2,0,6,6,132,63,0,2
8476871,Tanner Pearson,VAN,LW,80,18,9,27,-15,25,147,1,3,2,5,41,128,0,0
8470755,Brad Richardson,NSH,RW,66,19,8,27,6,22,128,3,0,0,0,55,63,3,3
8476393,Nick Cousins,NSH,C,81,7,20,27,-8,35,144,2,1,2,3,51,115,0,0
8477935,Sam Bennett,CGY,C,71,13,14,27,-6,93,115,2,4,2,6,27,121,0,0
8479398,Samuel Girard,COL,D,82,4,23,27,8,6,116,0,0,9,9,90,65,0,0
8477939,William Nylander,TOR,RW,54,7,20,27,-4,16,130,0,1,5,6,14,16,0,0
8471274,Alex Goligoski,ARI,D,76,3,24,27,-7,16,102,0,1,6,7,154,79,0,2
8474685,Matt Calvert,COL,LW,82,11,15,26,-10,58,141,0,1,1,2,51,115,0,2
8479370,Tyson Jost,COL,C,70,11,15,26,-2,14,114,3,4,1,5,35,48,0,0
8475181,Nick Leddy,NYI,D,82,4,22,26,0,18,116,0,0,10,10,89,77,0,0
8480145,Neal Pionk,WPG,D,73,6,20,26,-16,35,132,1,2,11,13,98,138,0,1
8475178,Zack Kassian,EDM,RW,79,15,11,26,-6,102,111,3,0,0,0,15,191,1,0
8478472,Mathieu Joseph,TBL,RW,70,13,13,26,5,26,95,1,0,0,0,14,129,0,2
8477964,Ivan Barbashev,STL,C,80,14,12,26,-4,17,60,1,0,0,0,31,86,2,0
8475714,Calle Jarnkrok,NSH,C,79,10,16,26,13,12,106,1,1,1,2,22,56,1,0
8473463,Leo Komarov,NYI,RW,82,6,20,26,18,42,78,1,0,0,0,38,203,0,0
8477451,Ryan Hartman,MIN,RW,83,12,14,26,1,74,145,2,0,0,0,39,107,0,0
8476879,Cody Ceci,PIT,D,74,7,19,26,-22,18,132,2,0,1,1,142,120,0,0
8475760,Nick Bjugstad,MIN,C,64,14,12,26,6,30,154,2,2,4,6,27,126,0,0
8476934,Brock McGinn,CAR,LW,82,10,16,26,10,20,123,0,0,0,0,38,137,1,0
8478500,Ivan Provorov,PHI,D,82,7,19,26,-16,32,145,1,0,2,2,149,123,0,0
8477406,Mattias Janmark,CHI,C,81,6,19,25,-4,24,105,0,0,1,1,44,28,0,1
8477444,Andre Burakovsky,COL,LW,76,12,13,25,2,14,100,4,1,0,1,29,35,0,0
8479999,Casey Mittelstadt,BUF,C,77,12,13,25,-19,10,118,1,3,7,10,16,30,0,0
8477987,Ryan Donato,SJS,C,56,10,15,25,-15,6,139,1,3,5,8,21,24,0,0
8478401,Pavel Zacha,NJD,C,61,13,12,25,-6,15,99,2,4,2,6,24,68,2,1
8473446,Erik Johnson,COL,D,80,7,18,25,8,38,144,1,0,0,0,143,124,0,0
8477969,Marcus Pettersson,PIT,D,84,2,23,25,17,66,87,0,1,4,5,108,101,0,1
8477937,Jake Virtanen,VAN,RW,70,15,10,25,-4,44,154,1,2,0,2,37,154,0,0
8476869,Brady Skjei,CAR,D,78,8,17,25,-4,44,126,1,0,0,0,119,178,0,1
8479482,Michal Kempny,WSH,D,71,6,19,25,24,60,111,3,0,0,0,135,84,0,0
8477951,Nick Schmaltz,ARI,C,40,7,18,25,-12,8,62,2,5,3,8,12,5,0,0
8477429,Andrew Copp,WPG,C,69,11,14,25,20,6,82,2,0,0,0,34,71,1,0
8472382,Andy Greene,NYI,D,82,5,20,25,-9,16,104,0,0,2,2,208,67,0,4
8477505,Alex Wennberg,FLA,C,75,2,23,25,-1,12,64,0,1,5,6,32,34,1,2
8471709,Marc-Edouard Vlasic,SJS,D,72,3,22,25,-6,10,100,0,0,1,1,114,23,0,0
8478474,Lawson Crouse,ARI,LW,81,11,14,25,5,67,131,1,0,0,0,44,288,2,0
8476921,Jordan Martinook,CAR,LW,82,15,10,25,1,38,146,5,0,0,0,46,199,1,0
8478458,Jack Roslovic,CBJ,C,77,9,15,24,-2,4,74,0,5,2,7,21,32,0,0
8475233,David Savard,CBJ,D,82,8,16,24,19,36,124,1,0,0,0,123,122,0,0
8477425,Miles Wood,NJD,LW,63,10,14,24,-10,91,159,1,1,2,3,27,97,0,0
8476410,Josh Leivo,CGY,LW,76,14,10,24,5,32,151,2,3,4,7,23,44,0,0
8478413,Jordan Greenway,MIN,LW,81,12,12,24,-12,29,109,0,0,0,0,40,57,0,0
8479465,Drake Caggiula,ARI,C,55,12,11,23,-5,28,96,2,0,0,0,26,135,1,0
8479425,Filip Hronek,DET,D,46,5,18,23,-10,30,73,0,1,4,5,32,66,0,1
8473504,Cal Clutterbuck,NYI,RW,73,8,15,23,6,44,95,2,3,0,3,40,209,0,1
8478466,Daniel Sprong,WSH,RW,63,14,9,23,-16,10,125,3,2,3,5,14,35,0,0
8479442,Troy Stecher,DET,D,78,2,21,23,9,32,105,0,0,2,2,96,91,1,0
8476822,Luke Glendening,DET,C,78,10,13,23,2,15,102,1,0,0,0,102,198,1,2
8475208,Brian Dumoulin,PIT,D,76,3,20,23,31,20,99,0,0,0,0,129,141,0,4
8475764,Cam Fowler,ANA,D,59,5,18,23,-14,20,88,2,1,5,6,91,32,0,1
8476442,Matt Nieto,SJS,LW,64,4,19,23,2,8,86,1,0,0,0,26,50,1,2
8476469,Joel Armia,MTL,RW,57,13,10,23,0,14,134,2,2,4,6,21,113,1,0
8473544,Derick Brassard,ARI,C,70,14,9,23,-19,39,110,0,2,3,5,15,102,0,0
8479353,Brett Howden,NYR,C,66,6,17,23,-16,14,74,1,0,2,2,47,64,0,0
8474068,Kyle Turris,EDM,C,55,7,16,23,-6,33,78,1,4,2,6,15,24,0,0
8480078,Filip Chytil,NYR,C,75,11,12,23,-22,8,133,2,3,4,7,21,29,0,0
8476392,Adam Lowry,WPG,C,78,12,11,23,6,33,105,3,0,0,0,49,223,1,2
8476331,Dylan DeMelo,WPG,D,77,4,18,22,-1,32,109,0,0,3,3,130,121,0,1
8475455,Brenden Dillon,WSH,D,82,1,21,22,19,61,71,0,0,0,0,78,202,1,0
8476856,Matt Dumba,MIN,D,32,12,10,22,-5,21,93,1,6,6,12,43,60,0,0
8476326,Josh Archibald,EDM,RW,68,12,10,22,1,15,92,1,0,0,0,39,161,0,1
8474818,Jordie Benn,VAN,D,81,5,17,22,15,39,93,1,0,0,0,128,124,0,0
8477450,Jason Dickinson,DAL,C,67,6,16,22,9,23,94,2,0,0,0,50,106,0,0
8478449,Roope Hintz,DAL,LW,58,9,13,22,-11,24,99,3,3,3,6,36,87,0,0
8475343,Nic Dowd,WSH,C,64,8,14,22,10,20,47,3,0,0,0,37,97,0,1
8478906,Markus Nutivaara,FLA,D,80,5,16,21,3,6,99,1,0,0,0,61,80,0,0
8476374,Sean Kuraly,BOS,C,71,8,13,21,6,38,134,3,0,0,0,35,129,0,0
8476917,Adam Pelech,NYI,D,78,5,16,21,22,24,110,0,0,0,0,116,149,0,0
8478455,Austin Wagner,LAK,LW,62,12,9,21,2,16,67,0,0,0,0,9,142,0,0
8475160,Kyle Clifford,STL,LW,72,11,10,21,4,96,115,2,1,0,1,24,115,0,0
8470655,David Backes,ANA,RW,70,7,13,20,0,31,129,1,2,5,7,30,140,0,0
8475855,Jesper Fast,CAR,RW,66,8,12,20,-3,26,80,1,0,0,0,47,120,0,0
8477482,Zach Sanford,STL,LW,60,8,12,20,8,21,77,2,0,1,1,37,48,0,0
8476329,Travis Boyd,TOR,C,53,5,15,20,6,6,35,1,0,2,2,21,13,0,0
8478131,Ondrej Kase,BOS,RW,30,11,9,20,0,2,94,2,1,3,4,11,17,0,0
8477215,Danny DeKeyser,DET,D,52,5,15,20,2,39,59,3,0,0,0,94,79,0,0
8471817,Ryan Reaves,VGK,RW,80,9,11,20,1,74,95,2,3,0,3,24,305,0,0
8477018,Ben Hutton,ANA,D,69,5,15,20,-23,43,114,1,1,7,8,102,55,0,1
8475279,Ben Chiarot,MTL,D,78,5,15,20,6,62,111,1,0,0,0,139,171,0,1
8477240,Carter Rowney,ANA,C,62,7,13,20,0,12,53,0,0,0,0,35,178,1,0
8477454,Adam Erne,DET,LW,65,7,13,20,10,40,70,3,2,0,2,26,159,0,0
8479345,Jakob Chychrun,ARI,D,53,5,15,20,-12,28,117,0,3,5,8,77,74,0,0
8476457,Adam Larsson,EDM,D,82,3,17,20,-28,44,117,0,0,0,0,128,256,0,1
8475462,Radko Gudas,FLA,D,77,4,16,20,6,63,136,0,0,0,0,133,255,0,0
8475324,Nick Jensen,WSH,D,80,2,18,20,4,21,94,0,0,0,0,105,82,0,1
8473473,Milan Lucic,CGY,LW,79,6,14,20,-9,91,74,0,2,2,4,22,259,0,0
8477851,Jordan Oesterle,ARI,D,71,6,14,20,-3,12,77,0,3,4,7,139,58,0,0
8477462,Robert Hagg,PHI,D,82,5,15,20,-3,63,86,1,0,0,0,158,258,0,0
8475220,Marcus Foligno,MIN,LW,82,7,12,19,-1,55,91,0,0,1,1,43,206,0,1
8475772,Riley Sheahan,BUF,C,82,9,10,19,-9,17,110,2,0,0,0,44,72,1,1
8476429,Scott Mayfield,NYI,D,79,4,15,19,18,68,104,0,0,0,0,159,118,1,0
8474176,Carl Hagelin,WSH,LW,58,5,14,19,7,30,99,2,0,0,0,20,64,0,0
8475780,Chris Wagner,BOS,RW,76,12,7,19,3,51,135,1,0,0,0,38,247,0,0
8471707,James Neal,EDM,LW,63,7,12,19,-5,28,141,1,2,4,6,19,46,0,0
8478397,Rasmus Andersson,CGY,D,79,2,17,19,17,23,115,0,0,2,2,83,52,0,0
8474567,Zach Bogosian,TOR,D,65,3,16,19,-5,52,93,0,0,1,1,116,83,1,0
8480144,David Kampf,CHI,C,63,4,15,19,-6,14,72,0,0,0,0,30,39,0,0
8474612,Travis Hamonic,VAN,D,69,7,12,19,21,33,128,1,0,0,0,167,44,1,2
8470187,Johnny Boychuk,NYI,D,74,3,16,19,10,25,157,1,1,2,3,120,144,0,1
8477903,Garnet Hathaway,WSH,RW,76,11,8,19,14,56,77,5,0,0,0,36,200,2,0
8477290,Michael Raffl,PHI,LW,67,6,12,18,-1,32,65,1,0,0,0,29,96,1,0
8478038,Devon Toews,COL,D,48,5,13,18,7,4,81,2,1,3,4,30,24,0,0
8477846,Ryan Carpenter,CHI,C,68,5,13,18,-6,8,102,0,0,0,0,17,126,1,1
8476915,Jujhar Khaira,EDM,LW,60,3,15,18,-12,43,64,0,0,0,0,33,123,1,1
8476463,Jonas Brodin,MIN,D,82,4,14,18,-15,30,111,2,0,1,1,135,61,1,0
8471260,Blake Comeau,DAL,LW,77,7,11,18,-7,42,102,2,0,0,0,40,208,0,0
8476878,Zemgus Girgensons,BUF,LW,72,5,13,18,-11,17,78,0,0,0,0,29,144,0,0
8474589,Tyler Ennis,EDM,C,51,12,6,18,-6,2,81,1,2,3,5,14,49,0,0
8478432,Christian Fischer,ARI,RW,71,11,7,18,-13,27,116,0,0,0,0,19,124,0,0
8476891,Matt Grzelcyk,BOS,D,66,3,15,18,9,68,90,0,1,5,6,60,46,0,0
8478856,Conor Garland,ARI,RW,47,13,5,18,1,12,118,2,4,2,6,17,33,0,0
8474166,Alec Martinez,VGK,D,60,4,14,18,-2,8,78,2,0,2,2,135,78,0,0
8479316,Luke Kunin,NSH,C,49,6,11,17,-9,27,88,1,0,1,1,34,67,0,0
8476449,Scott Harrington,CBJ,D,73,2,15,17,6,23,54,0,0,0,0,81,73,0,0
8477931,Tomas Nosek,VGK,LW,68,8,9,17,-10,18,116,1,0,0,0,23,75,1,0
8471699,Andrew Cogliano,DAL,C,78,6,11,17,1,22,106,1,1,0,1,32,68,0,0
8476988,Matt Benning,NSH,D,70,5,12,17,11,33,94,0,0,1,1,59,109,0,1
8475222,Sami Vatanen,NJD,D,50,4,13,17,-17,22,107,0,3,2,5,77,68,0,0
8478408,Travis Dermott,TOR,D,64,4,13,17,-5,22,98,0,0,0,0,57,100,0,0
8476967,Brett Kulak,MTL,D,57,6,11,17,12,31,102,3,0,0,0,64,107,1,0
8476624,Barclay Goodrow,TBL,C,82,7,10,17,4,76,84,3,0,0,0,68,125,1,0
8471873,Anton Stralman,FLA,D,47,2,15,17,12,8,57,0,0,1,1,71,59,0,0
8477962,Brendan Lemieux,NYR,LW,63,12,5,17,6,108,67,1,0,0,0,31,129,0,0
8476975,Cedric Paquette,OTT,C,80,13,4,17,7,80,87,1,0,0,0,61,269,2,0
8471794,Darren Helm,DET,LW,61,7,10,17,-11,20,107,0,0,0,0,26,50,1,3
8477353,Tyler Motte,VAN,C,74,9,7,16,-12,10,114,1,0,0,0,52,200,2,0
8471729,Kris Russell,EDM,D,72,3,13,16,5,27,63,0,0,0,0,185,93,0,1
8474027,Justin Braun,PHI,D,78,2,14,16,-14,35,105,0,0,1,1,120,121,0,0
8475188,Brayden McNabb,VGK,D,81,4,12,16,11,52,84,1,0,0,0,139,200,0,1
8478416,Erik Cernak,TBL,D,58,5,11,16,25,58,107,1,1,0,1,79,198,0,0
8475766,Austin Watson,OTT,LW,37,7,9,16,11,39,64,1,1,0,1,28,109,0,0
8476312,Josh Manson,ANA,D,74,3,13,16,-8,62,96,0,0,0,0,90,184,0,1
8477998,Warren Foegele,CAR,LW,77,10,5,15,-17,20,106,3,0,0,0,19,126,0,0
8477346,MacKenzie Weegar,FLA,D,64,4,11,15,-3,64,79,2,0,1,1,103,127,0,0
8474098,Colton Sceviour,PIT,C,59,5,10,15,-2,15,116,0,0,1,1,58,89,0,0
8475750,Jon Merrill,DET,D,57,3,12,15,16,53,72,0,0,0,0,72,71,1,0
8477930,Pierre-Edouard Bellemare,COL,C,76,6,9,15,2,6,108,0,0,0,0,51,71,2,0
8474602,Justin Schultz,WSH,D,29,2,13,15,0,4,47,0,1,5,6,41,25,0,0
8474207,Nick Holden,VGK,D,61,3,12,15,5,14,77,0,0,0,0,76,104,0,2
8474013,Ian Cole,MIN,D,71,2,13,15,-1,115,82,0,0,0,0,178,107,0,0
8474709,Matt Martin,NYI,LW,67,6,8,14,5,53,62,1,0,0,0,42,275,0,0
8465009,Zdeno Chara,WSH,D,62,5,9,14,22,57,99,2,1,2,3,88,81,0,0
8475728,Johan Larsson,ARI,LW,73,6,8,14,-8,37,79,0,0,0,0,44,112,1,0
8477845,Trevor van Riemsdyk,WSH,D,78,3,11,14,-4,10,102,1,0,0,0,84,42,0,0
8477507,Nikita Zadorov,CHI,D,70,7,7,14,19,75,100,0,0,0,0,67,228,0,0
8478569,Noel Acciari,FLA,C,72,6,8,14,-3,47,99,2,0,0,0,36,221,0,0
8475177,Calvin de Haan,CHI,D,74,1,13,14,1,20,102,1,0,0,0,106,187,0,0
8476931,Jake McCabe,BUF,D,59,4,10,14,-4,35,64,0,0,0,0,99,103,1,0
8479458,Nikita Zaitsev,OTT,D,81,3,11,14,2,18,71,0,0,0,0,151,139,0,0
8478870,Rudolfs Balcers,SJS,LW,36,5,9,14,-7,10,48,1,3,1,4,24,18,0,0
8476874,Olli Maatta,LAK,D,60,1,13,14,9,12,74,1,1,3,4,116,97,0,0
8474683,Derek Grant,ANA,C,56,4,10,14,-6,14,74,1,0,0,0,29,92,0,1
8471273,Brandon Dubinsky,CBJ,C,61,6,8,14,-16,36,63,0,0,0,0,28,147,0,1
8478493,Joel Eriksson Ek,MIN,C,58,7,7,14,-7,20,111,2,0,0,0,24,117,0,0
8475762,Derek Forbort,WPG,D,81,2,12,14,-13,52,75,1,0,0,0,139,105,0,0
8478020,Michael Amadio,LAK,C,43,6,7,13,-1,6,37,0,0,0,0,13,16,0,0
8470775,Nate Thompson,WPG,C,78,5,8,13,-1,17,71,0,0,0,0,44,87,0,0
8479376,Victor Mete,MTL,D,71,0,13,13,17,6,65,0,0,0,0,95,21,0,0
8474291,Jay Beagle,VAN,C,57,3,10,13,-8,18,45,0,0,0,0,33,102,1,0
8478873,Troy Terry,ANA,RW,32,4,9,13,8,2,25,0,2,4,6,12,4,0,0
8478233,Andrew Mangiapane,CGY,LW,44,8,5,13,11,12,65,1,0,0,0,17,43,0,0
8475186,John Moore,BOS,D,61,4,9,13,0,26,97,1,2,1,3,76,77,0,0
8474090,Brendan Smith,NYR,D,63,4,9,13,-7,71,66,0,0,0,0,48,100,0,1
8471677,Jack Johnson,NYR,D,82,1,12,13,-4,41,86,0,1,1,2,147,233,0,2
8476473,Connor Murphy,CHI,D,52,5,8,13,12,40,84,1,0,0,0,91,119,0,0
8476428,Rocco Grimaldi,NSH,RW,53,5,8,13,-2,10,81,0,0,0,0,20,32,0,0
8474618,Marco Scandella,STL,D,63,6,7,13,-13,26,83,1,0,0,0,75,53,0,1
8474040,Sam Gagner,DET,C,32,6,7,13,-6,14,68,1,1,0,1,7,21,0,0
8471686,Marc Staal,DET,D,79,3,10,13,-9,32,84,0,0,0,0,119,94,0,0
8478846,Christian Wolanin,OTT,D,30,4,8,12,3,6,36,1,0,3,3,31,11,0,0
8480748,Kiefer Sherwood,COL,LW,50,6,6,12,1,8,60,1,0,0,0,19,79,0,0
8475752,Tyler Pitlick,ARI,C,47,8,4,12,-2,6,75,1,1,0,1,27,93,0,0
8479420,Tage Thompson,BUF,RW,65,7,5,12,-22,20,108,0,1,0,1,9,66,0,0
8476419,Jean-Gabriel Pageau,NYI,C,39,4,8,12,-12,14,83,0,0,0,0,38,63,0,0
8475690,Christopher Tanev,CGY,D,55,2,10,12,3,18,51,0,0,0,0,122,29,0,0
8475807,Joakim Nordstrom,CGY,C,70,7,5,12,0,13,103,3,0,0,0,52,86,0,0
8476470,Nathan Beaulieu,WPG,D,48,3,9,12,6,39,60,0,0,1,1,42,60,0,0
8478874,Adam Gaudette,VAN,C,56,5,7,12,-8,18,55,1,0,2,2,15,48,0,0
8474062,Riley Nash,CBJ,C,78,3,9,12,-8,19,79,1,0,0,0,43,72,0,0
8477963,Jayce Hawryluk,VAN,C,42,7,5,12,-8,16,35,0,0,1,1,25,101,0,0
8480035,Henri Jokiharju,BUF,D,38,0,12,12,-7,16,62,0,0,1,1,37,48,0,0
8476779,Brad Hunt,MIN,D,42,5,7,12,-2,8,75,1,4,4,8,28,18,0,0
8473453,Trevor Lewis,WPG,C,44,3,9,12,-9,9,87,1,0,0,0,25,53,0,0
8476467,Jamie Oleksiak,DAL,D,57,4,8,12,5,45,55,0,0,0,0,59,135,0,0
8476166,Taylor Fedun,DAL,D,54,4,7,11,2,14,86,0,0,2,2,58,19,0,1
8476356,Tobias Rieder,BUF,LW,67,0,11,11,-8,8,92,0,0,2,2,44,69,0,0
8476941,Connor Carrick,NJD,D,34,2,9,11,-13,19,42,1,0,1,1,37,25,0,0
8476441,Joel Edmundson,MTL,D,64,2,9,11,8,68,102,1,0,0,0,106,128,0,0
8476905,Chandler Stephenson,VGK,C,64,5,6,11,-13,0,36,0,0,0,0,33,38,1,0
8479351,Sam Steel,ANA,C,22,6,5,11,2,8,33,0,0,2,2,6,9,1,0
8476422,Mike Reilly,OTT,D,57,3,8,11,0,16,101,1,1,0,1,53,48,0,0
8475796,Mark Pysyk,DAL,D,70,1,10,11,-1,26,64,0,0,0,0,89,133,0,1
8479644,Matt Luff,LAK,RW,33,8,3,11,-2,9,45,2,1,0,1,19,17,0,0
8474145,Robert Bortuzzo,STL,D,59,2,8,10,9,47,75,0,0,0,0,72,95,0,1
8478443,Brandon Carlo,BOS,D,72,2,8,10,22,47,116,0,0,0,0,88,134,0,2
8475747,Patrik Nemeth,DET,D,74,1,9,10,5,53,57,0,0,0,0,131,137,0,1
8478891,Mason Appleton,WPG,C,36,3,7,10,9,4,29,1,0,0,0,12,28,0,0
8471769,Niklas Hjalmarsson,ARI,D,82,0,10,10,8,44,57,0,0,0,0,187,45,0,2
8479291,Kevin Rooney,NYR,C,41,6,4,10,-4,15,39,1,0,0,0,22,77,1,0
8474584,Michael Del Zotto,CBJ,D,42,1,9,10,-2,8,45,0,0,0,0,53,129,0,0
8477501,Valeri Nichushkin,COL,RW,57,0,10,10,-4,0,65,0,0,0,0,32,71,0,0
8470621,Corey Perry,MTL,RW,31,6,4,10,-16,27,59,1,2,2,4,14,21,0,0
8480336,Sean Walker,LAK,D,39,3,7,10,-8,8,55,0,1,0,1,40,43,0,0
8476927,Teddy Blueger,PIT,C,28,6,4,10,7,15,33,1,0,0,0,14,52,1,2
8475790,Erik Gudbranson,OTT,D,76,2,8,10,-20,87,94,1,0,0,0,84,184,0,1
8476285,Matthew Peca,OTT,C,39,3,7,10,-14,4,35,0,0,0,0,21,33,0,1
8477474,Madison Bowey,CHI,D,50,2,8,10,-1,46,48,1,0,0,0,63,72,0,0
8477043,Christian Djoos,DET,D,45,1,9,10,9,4,33,0,0,0,0,28,18,0,0
8478055,Gustav Forsling,FLA,D,43,3,6,9,-9,30,57,0,0,0,0,38,38,0,0
8480208,Drake Batherson,OTT,RW,20,3,6,9,-2,6,18,2,2,1,3,21,17,0,0
8479344,Jesse Puljujarvi,EDM,RW,46,4,5,9,-14,16,53,0,0,1,1,26,46,0,0
8480160,Radim Simek,SJS,D,41,1,8,9,7,8,41,1,0,0,0,34,67,0,0
8477455,Jacob de la Rose,STL,LW,60,3,6,9,-13,16,55,0,0,0,0,29,72,0,0
8477478,William Carrier,VGK,LW,54,8,1,9,-4,29,85,1,0,0,0,13,277,0,0
8476437,Victor Rask,MIN,C,49,3,6,9,-4,8,55,0,0,2,2,12,40,0,0
8476474,Stefan Noesen,SJS,RW,41,3,5,8,-19,28,64,0,0,0,0,21,95,0,0
8478430,Oliver Kylington,CGY,D,38,3,5,8,3,10,21,1,0,0,0,41,11,0,0
8474218,Jason Demers,ARI,D,35,2,6,8,9,12,39,2,0,1,1,43,50,0,0
8480172,Jan Rutta,TBL,D,37,2,6,8,4,16,42,0,0,0,0,30,24,0,0
8475246,Kevin Connauton,FLA,D,50,1,7,8,-2,22,75,0,0,0,0,75,108,0,2
8479675,Trevor Moore,LAK,C,25,2,6,8,1,2,26,0,0,0,0,7,15,0,0
8474134,Yannick Weber,PIT,D,62,2,6,8,7,18,67,0,0,0,0,32,64,0,0
8480031,Max Comtois,ANA,LW,10,2,5,7,3,7,9,1,0,0,0,3,27,0,0
8475625,Matt Irwin,BUF,D,44,1,6,7,5,38,50,0,0,0,0,37,80,0,0
8474125,Carl Gunnarsson,STL,D,25,3,4,7,8,6,21,1,0,0,0,35,11,0,1
8474688,Greg Pateryn,COL,D,80,1,6,7,-11,41,100,0,0,0,0,118,144,0,0
8476191,Kevan Miller,BOS,D,39,0,7,7,8,35,32,0,0,0,0,79,73,0,0
8477936,Michael Dal Colle,NYI,LW,28,3,4,7,3,2,34,2,0,0,0,8,10,0,0
8477989,Christian Dvorak,ARI,C,20,2,5,7,-2,2,25,1,1,0,1,7,16,0,0
8475287,Erik Haula,NSH,LW,15,2,5,7,1,10,26,0,0,1,1,6,11,0,0
8476439,Brett Ritchie,CGY,RW,53,4,2,6,-7,57,57,2,1,0,1,13,126,0,0
8474230,Micheal Haley,OTT,LW,43,2,4,6,-2,75,34,0,0,0,0,16,76,0,0
8480326,Sheldon Dries,COL,C,40,3,3,6,-7,26,44,0,0,0,0,20,66,1,0
8479336,Carl Grundstrom,LAK,RW,15,5,1,6,-4,6,26,1,0,1,1,3,38,0,0
8477520,Jean-Sebastien Dea,BUF,C,23,4,2,6,0,8,29,1,0,0,0,12,21,0,0
8477952,Robby Fabbri,DET,C,32,2,4,6,-4,6,43,1,0,0,0,8,30,0,0
8476924,Martin Frk,LAK,RW,30,1,5,6,-9,4,28,0,1,0,1,4,35,0,0
8478911,Matt Roy,LAK,D,25,2,4,6,-1,8,34,1,0,0,0,47,38,0,0
8475179,Dmitry Kulikov,NJD,D,57,0,6,6,4,47,40,0,0,0,0,71,88,0,0
8477996,Juho Lammikko,FLA,C,40,0,6,6,-7,6,39,0,0,0,0,21,45,0,1
8480072,Lias Andersson,LAK,C,42,2,4,6,-13,29,41,0,0,0,0,8,60,1,0
8474091,Brandon Sutter,VAN,C,26,4,2,6,-12,6,43,0,1,0,1,13,33,1,0
8478452,Caleb Jones,EDM,D,17,1,5,6,-9,6,21,0,0,1,1,18,20,0,0
8476886,Slater Koekkoek,EDM,D,31,2,4,6,4,14,36,0,0,0,0,48,54,0,0
8478567,Dean Kukan,CBJ,D,25,0,5,5,6,6,16,0,0,0,0,21,16,0,0
8477433,Ben Harpur,NSH,D,51,1,4,5,-13,56,50,0,0,0,0,69,89,0,0
8475235,Nicolas Deslauriers,ANA,LW,48,2,3,5,-12,22,48,0,0,0,0,22,135,1,0
8476907,Mackenzie MacEachern,STL,LW,29,3,2,5,0,10,33,1,0,0,0,4,49,0,0
8478491,Jacob Larsson,ANA,D,49,0,5,5,-4,16,57,0,0,0,0,59,41,0,0
8480945,Juuso Riikola,PIT,D,37,2,3,5,3,10,43,1,2,0,2,38,86,0,0
8474697,Mark Borowiecki,NSH,D,53,1,4,5,-12,89,59,0,0,0,0,93,212,0,0
8478454,Noah Juulsen,FLA,D,21,1,4,5,5,6,22,0,0,0,0,39,60,0,0
8477435,Ryan Graves,COL,D,26,3,2,5,4,2,26,0,0,0,0,51,32,0,0
8479346,Dillon Dube,CGY,C,25,1,4,5,2,4,22,0,0,0,0,3,11,0,0
8477401,John Hayden,ARI,C,54,3,2,5,-12,27,42,0,0,0,0,23,97,0,0
8474066,Thomas Hickey,NYI,D,40,0,4,4,5,33,47,0,0,0,0,71,40,0,1
8477919,Frederick Gaudreau,PIT,C,55,3,1,4,1,2,43,1,0,0,0,18,25,0,0
8478399,Jonas Siegenthaler,WSH,D,26,0,4,4,6,10,12,0,0,0,0,44,31,0,0
8476407,Andy Welinski,ANA,D,26,1,3,4,-5,8,32,0,0,0,0,18,47,0,0
8477527,Ross Johnston,NYI,LW,17,1,3,4,3,23,12,0,0,0,0,1,43,0,0
8476858,Phillip Di Giuseppe,NYR,LW,24,1,3,4,-3,8,31,0,0,0,0,9,54,0,0
8478109,Victor Olofsson,BUF,LW,6,2,2,4,1,2,21,0,2,0,2,3,2,0,0
8479423,Alex Nylander,CHI,LW,12,2,2,4,-4,4,16,0,1,0,1,1,1,0,0
8480950,Ilya Lyubushkin,ARI,D,41,0,4,4,-9,13,27,0,0,0,0,61,150,0,0
8478915,Sami Niku,WPG,D,30,1,3,4,0,2,19,0,0,0,0,30,10,0,0
8478495,Denis Gurianov,DAL,RW,21,1,3,4,-3,0,23,0,0,1,1,9,23,0,0
8478104,Sammy Blais,STL,LW,32,2,2,4,-1,6,27,0,0,0,0,12,93,0,0
8471284,Andrej Sekera,DAL,D,24,0,4,4,3,6,28,0,0,1,1,21,17,0,0
8480821,Filip Zadina,DET,RW,9,1,2,3,-5,0,18,0,1,1,2,3,6,0,0
8479415,Michael McLeod,NJD,C,21,0,3,3,-8,13,21,0,0,0,0,4,41,0,0
8479414,Nathan Bastian,NJD,RW,7,3,0,3,0,10,13,0,0,0,0,1,24,0,0
8479976,Juuso Valimaki,CGY,D,24,1,2,3,-2,12,28,1,0,0,0,43,21,0,0
8474736,Zac Rinaldo,CGY,C,23,1,2,3,1,20,11,1,0,0,0,8,47,0,0
8475868,Anthony Bitetto,NYR,D,36,0,3,3,-7,12,30,0,0,0,0,36,80,0,0
8479968,Vinni Lettieri,ANA,C,27,1,2,3,-7,14,40,0,1,1,2,11,41,0,0
8479385,Jordan Kyrou,STL,C,16,1,2,3,-1,4,16,0,0,0,0,3,2,0,0
8476966,Gemel Smith,TBL,C,17,2,1,3,-4,0,14,0,0,0,0,3,13,0,0
8480800,Quinn Hughes,VAN,D,5,0,3,3,0,2,6,0,0,2,2,1,1,0,0
8478075,Anders Bjork,BOS,LW,20,1,2,3,-1,2,18,0,0,0,0,12,9,0,0
8477464,Nic Petan,TOR,C,18,1,2,3,-5,2,15,1,0,0,0,4,2,0,0
8479977,Kailer Yamamoto,EDM,RW,17,1,1,2,-6,2,13,0,0,1,1,11,18,0,0
8480083,C.J. Smith,BUF,LW,11,2,0,2,0,0,18,1,0,0,0,1,4,0,0
8474568,Luke Schenn,TBL,D,26,0,2,2,-10,16,30,0,0,0,0,39,105,0,0
8477384,Josh Brown,OTT,D,37,1,1,2,-3,28,28,0,0,0,0,31,80,0,0
8480009,Eeli Tolvanen,NSH,RW,4,1,1,2,2,0,2,0,0,1,1,2,4,0,0
8479026,Philippe Myers,PHI,D,21,1,1,2,-5,2,25,0,0,0,0,8,42,0,0
8477426,Nick Paul,OTT,LW,20,1,1,2,-10,4,30,0,0,0,0,4,28,0,0
8477244,Chad Ruhwedel,PIT,D,18,1,1,2,-9,4,22,1,0,0,0,16,40,0,0
8480806,Isac Lundestrom,ANA,C,15,0,2,2,-1,2,13,0,0,0,0,5,4,0,0
8480039,Martin Necas,CAR,C,7,1,1,2,0,2,6,0,0,0,0,2,3,0,0
8477366,Luke Johnson,MIN,C,15,0,1,1,-8,8,19,0,0,1,1,9,31,0,0
8479994,Jaret Anderson-Dolan,LAK,C,5,0,1,1,-2,0,6,0,0,0,0,2,5,0,0
8477365,Connor Clifton,BOS,D,19,0,1,1,5,15,22,0,0,0,0,13,40,0,0
8477073,Kurtis MacDermid,LAK,D,11,0,1,1,-1,11,5,0,0,0,0,4,26,0,0
8480074,Alexandre Texier,CBJ,C,2,1,0,1,3,0,6,0,0,0,0,1,2,0,0
8475869,Brandon Davidson,BUF,D,10,0,1,1,-4,15,7,0,0,0,0,15,17,0,0
8478468,Jeremy Lauzon,BOS,D,16,1,0,1,-1,2,11,1,0,0,0,15,15,0,0
8479371,Dante Fabbro,NSH,D,4,1,0,1,-1,0,5,0,0,0,0,6,3,0,0
8476415,Kyle Rau,MIN,C,6,0,1,1,0,0,6,0,0,0,0,2,11,0,0
8474749,Matt Bartkowski,MIN,D,2,1,0,1,2,0,2,0,0,0,0,1,1,0,0
8478488,Filip Chlapik,OTT,C,5,1,0,1,-2,4,9,0,0,0,0,4,1,0,0
8480005,Kristian Vesalainen,WPG,LW,5,0,1,1,0,0,1,0,0,0,0,1,1,0,0
8479772,Zack MacEwen,VAN,C,4,0,1,1,-4,5,2,0,0,0,0,1,4,0,0
8477947,Sonny Milano,ANA,LW,8,1,0,1,0,0,5,0,0,0,0,0,5,0,0
8475718,Justin Holl,TOR,D,11,0,1,1,-5,2,6,0,0,0,0,5,9,0,0
8476323,Max McCormick,CAR,LW,14,1,0,1,-6,4,12,0,0,0,0,6,21,0,0
8477938,Haydn Fleury,CAR,D,20,0,1,1,4,2,17,0,0,0,0,21,25,0,0
8477901,Daniel Carr,WSH,LW,6,1,0,1,-1,0,11,0,0,0,0,3,9,0,0
8474579,Luca Sbisa,NSH,D,9,0,1,1,0,4,5,0,0,0,0,7,17,0,0
8477473,Justin Bailey,VAN,RW,11,0,1,1,0,2,5,0,0,0,0,5,9,0,0
8475413,Justin Dowling,DAL,C,11,0,1,1,-4,0,9,0,0,0,0,7,11,0,0
8479333,Libor Hajek,NYR,D,5,1,0,1,1,6,10,0,0,0,0,3,5,0,0
8479439,Jacob MacDonald,COL,D,2,1,0,1,1,0,1,0,0,0,0,1,1,0,0
8480803,Evan Bouchard,EDM,D,7,1,0,1,-5,2,10,0,1,0,1,8,6,0,0
8476807,Matt Tennyson,NJD,D,4,0,0,0,-4,0,4,0,0,0,0,2,10,0,0
8478476,Kyle Capobianco,ARI,D,2,0,0,0,-2,0,1,0,0,0,0,2,2,0,0
8478011,Louie Belpedio,MIN,D,2,0,0,0,0,0,0,0,0,0,0,4,1,0,0
8477541,Dakota Mermis,MIN,D,1,0,0,0,1,0,0,0,0,0,0,0,0,0,0
8478017,Mark Friedman,PHI,D,1,0,0,0,-1,0,1,0,0,0,0,0,1,0,0
8478462,Nicolas Roy,VGK,C,6,0,0,0,0,2,1,0,0,0,0,1,7,0,0
8481477,Nico Sturm,MIN,C,2,0,0,0,0,0,7,0,0,0,0,2,3,0,0
8479324,Ryan Lindgren,NYR,D,5,0,0,0,-6,8,8,0,0,0,0,9,11,0,0
8476278,Colin Blackwell,NYR,C,6,0,0,0,-1,2,5,0,0,0,0,3,10,0,0
8477979,Nicolas Aube-Kubel,PHI,RW,9,0,0,0,1,0,2,0,0,0,0,0,14,0,0
8479511,Janne Kuokkanen,NJD,LW,7,0,0,0,-2,4,6,0,0,0,0,3,0,0,0
8477810,Joel Hanley,DAL,D,16,0,0,0,0,2,9,0,0,0,0,16,16,0,0
8480762,Eric Robinson,CBJ,LW,13,0,0,0,-4,0,18,0,0,0,0,1,24,0,0
8478073,Anton Lindholm,CHI,D,2,0,0,0,-1,0,0,0,0,0,0,1,1,0,0
8481186,Logan O'Connor,COL,RW,5,0,0,0,-2,0,1,0,0,0,0,1,4,0,0
8479466,Patrick Russell,EDM,RW,6,0,0,0,0,2,6,0,0,0,0,2,9,0,0
8479066,Ryan Lomberg,FLA,LW,4,0,0,0,0,17,1,0,0,0,0,0,12,0,0
8478502,Dennis Gilbert,COL,D,1,0,0,0,0,2,0,0,0,0,0,1,6,0,0
8477508,Curtis Lazar,BUF,C,1,0,0,0,-1,0,0,0,0,0,0,1,0,0,0
8478840,William Borgen,BUF,D,4,0,0,0,-5,0,2,0,0,0,0,3,12,0,0
8479365,Trent Frederic,BOS,C,15,0,0,0,-4,15,19,0,0,0,0,3,18,0,0
8479580,Dylan Gambrell,SJS,C,8,0,0,0,1,2,6,0,0,0,0,1,13,0,0
8478415,Jakub Zboril,BOS,D,2,0,0,0,0,0,1,0,0,0,0,0,3,0,0
8478506,Gabriel Carlsson,CBJ,D,1,0,0,0,-1,2,1,0,0,0,0,0,0,0,0
8478831,Kevin Stenlund,CBJ,C,4,0,0,0,0,4,3,0,0,0,0,1,3,0,0
8480073,Erik Brannstrom,OTT,D,2,0,0,0,0,0,0,0,0,0,0,1,1,0,0
