player_id,Player Name,Team,Position,Games,G,A,Points,+/-,PIM,SOG,GWG,PPG,PPA,PPP,BS,Hits,SHG,SHA
8478402,Connor McDavid,EDM,C,82,41,67,108,20,26,274,7,5,15,20,46,28,1,3
8473512,Claude Giroux,PHI,C,82,34,68,102,28,20,193,1,9,27,36,23,30,0,0
8471215,Evgeni Malkin,PIT,C,78,42,56,98,16,87,239,7,14,24,38,32,48,0,0
8477492,Nathan MacKinnon,COL,C,74,39,58,97,11,55,284,12,12,20,32,22,38,0,1
8475791,Taylor Hall,BUF,LW,76,39,54,93,14,34,278,7,13,24,37,44,72,1,0
8471685,Anze Kopitar,LAK,C,82,35,57,92,21,20,200,6,7,20,27,64,50,0,2
8473548,Phil Kessel,ARI,RW,82,34,58,92,-4,36,261,6,12,30,42,17,10,0,0
8471218,Blake Wheeler,WPG,RW,81,23,68,91,13,52,246,2,6,34,40,66,94,0,2
8471675,Sidney Crosby,PIT,C,82,29,60,89,0,46,247,6,9,29,38,36,75,0,0
8471214,Alex Ovechkin,WSH,LW,82,49,38,87,3,32,355,7,17,14,31,21,139,0,0
8474564,Steven Stamkos,TBL,C,78,27,59,86,18,72,212,1,15,18,33,35,61,0,0
8478445,Mathew Barzal,NYI,C,82,22,63,85,1,30,170,4,5,22,27,31,21,0,0
8473419,Brad Marchand,BOS,LW,68,34,51,85,25,63,182,8,8,15,23,25,37,1,3
8474161,Jakub Voracek,PHI,RW,82,20,65,85,10,50,228,3,5,30,35,32,23,0,0
8475166,John Tavares,TOR,C,82,37,47,84,-12,26,257,3,12,18,30,34,30,2,1
8476346,Johnny Gaudreau,CGY,LW,80,24,60,84,2,26,227,4,3,21,24,18,16,0,0
8478420,Mikko Rantanen,COL,RW,81,29,55,84,0,34,178,3,12,23,35,40,32,0,0
8475744,Evgeny Kuznetsov,WSH,C,79,27,56,83,3,48,187,8,7,23,30,26,50,1,0
8478550,Artemi Panarin,NYR,LW,81,27,55,82,23,26,228,5,7,14,21,19,15,0,0
8477956,David Pastrnak,BOS,RW,82,35,45,80,10,37,246,5,13,13,26,31,55,0,0
8473994,Jamie Benn,DAL,LW,82,36,43,79,20,54,241,7,9,13,22,62,140,1,1
8475794,Tyler Seguin,DAL,C,82,40,38,78,12,43,335,6,14,11,25,44,74,1,1
8477493,Aleksander Barkov,FLA,C,79,27,51,78,9,14,256,3,5,12,17,67,30,5,0
8476448,William Karlsson,VGK,C,82,43,35,78,49,12,184,6,8,8,16,45,48,4,1
8476461,Sean Couturier,PHI,C,82,31,45,76,34,31,227,6,7,7,14,44,74,0,0
8474141,Patrick Kane,CHI,RW,82,27,49,76,-20,32,285,4,5,17,22,14,18,0,0
8470595,Eric Staal,BUF,C,82,42,34,76,8,42,241,4,11,6,17,49,42,2,1
8476389,Vincent Trocheck,CAR,C,82,31,44,75,-9,54,287,5,13,14,27,55,145,3,1
8476539,Jonathan Marchessault,VGK,C,77,27,48,75,36,40,268,6,6,10,16,26,99,0,0
8471228,Alexander Radulov,DAL,RW,82,27,45,72,4,72,217,4,7,16,23,64,77,0,0
8474573,Josh Bailey,NYI,RW,76,18,53,71,-20,17,151,3,5,26,31,33,12,0,0
8473563,Nicklas Backstrom,WSH,C,81,21,50,71,5,46,165,4,7,19,26,51,37,0,0
8477934,Leon Draisaitl,EDM,C,78,25,45,70,-7,30,194,1,6,5,11,24,40,3,1
8479339,Patrik Laine,CBJ,RW,82,44,26,70,8,24,241,8,20,11,31,43,74,0,0
8475170,Brayden Schenn,STL,C,82,28,42,70,10,56,210,8,8,11,19,37,154,0,0
8478483,Mitchell Marner,TOR,RW,82,22,47,69,-1,26,194,2,8,19,27,25,31,0,0
8476483,Rickard Rakell,ANA,LW,77,34,35,69,6,14,230,3,8,10,18,30,115,0,0
8476456,Jonathan Huberdeau,FLA,LW,82,27,42,69,-2,32,204,4,7,12,19,42,41,0,0
8474590,John Carlson,WSH,D,82,15,53,68,0,32,237,4,4,28,32,146,47,0,0
8475906,John Klingberg,DAL,D,82,8,59,67,10,26,204,3,1,22,23,109,44,0,0
8475798,Mikael Granlund,NSH,C,77,21,46,67,13,18,193,2,7,12,19,45,47,1,2
8470613,Brent Burns,SJS,D,82,12,55,67,-16,46,332,2,5,22,27,136,79,0,1
8478010,Brayden Point,TBL,C,82,32,34,66,18,24,217,12,5,6,11,57,26,3,2
8470794,Joe Pavelski,DAL,C,82,22,44,66,0,41,224,1,7,16,23,70,93,0,0
8474102,David Perron,STL,LW,70,16,50,66,1,50,125,4,1,17,18,20,118,0,0
8476906,Shayne Gostisbehere,PHI,D,78,13,52,65,10,25,221,2,7,26,33,116,53,0,0
8479343,Clayton Keller,ARI,RW,82,23,42,65,-7,24,212,3,6,14,20,28,7,0,1
8478427,Sebastian Aho,CAR,C,78,29,36,65,4,24,200,4,8,8,16,17,65,0,0
8474149,Evgenii Dadonov,OTT,RW,74,28,37,65,10,8,188,6,6,7,13,33,27,0,0
8476826,Yanni Gourde,TBL,C,82,25,39,64,34,50,136,5,7,6,13,42,57,1,1
8475722,Jason Zucker,PIT,LW,82,33,31,64,8,44,222,7,7,9,16,47,80,1,1
8476882,Teuvo Teravainen,CAR,LW,82,23,41,64,8,14,185,3,5,15,20,22,26,0,0
8476887,Filip Forsberg,NSH,LW,67,26,38,64,27,38,179,6,13,8,21,37,86,0,1
8478403,Jack Eichel,BUF,C,67,25,39,64,-25,32,246,4,3,17,20,35,52,0,2
8477497,Sean Monahan,CGY,C,74,31,33,64,3,24,202,11,9,10,19,17,35,0,0
8475167,Victor Hedman,TBL,D,77,17,46,63,32,54,216,1,2,24,26,110,139,0,2
8470638,Patrice Bergeron,BOS,C,64,30,33,63,21,26,224,6,10,11,21,42,48,2,1
8479318,Auston Matthews,TOR,C,62,34,29,63,25,12,187,5,5,8,13,61,16,0,0
8477946,Dylan Larkin,DET,C,82,16,47,63,-9,61,232,4,1,7,8,42,76,2,1
8475314,Anders Lee,NYI,LW,82,40,22,62,-25,44,208,2,14,8,22,38,102,0,0
8475913,Mark Stone,VGK,RW,58,20,42,62,9,10,132,3,1,10,11,39,53,1,1
8474578,Erik Karlsson,SJS,D,71,9,53,62,-25,36,196,2,3,15,18,120,58,0,1
8476455,Gabriel Landeskog,COL,LW,78,25,37,62,16,37,183,1,8,9,17,51,149,0,1
8478042,Viktor Arvidsson,NSH,RW,78,29,32,61,20,36,247,6,3,5,8,52,30,3,0
8474053,Logan Couture,SJS,C,78,34,27,61,-2,18,204,4,10,11,21,72,33,2,1
8470606,Dustin Brown,LAK,RW,81,28,33,61,31,58,222,6,9,6,15,33,189,1,0
8470612,Ryan Getzlaf,ANA,C,56,11,50,61,20,42,117,0,0,13,13,57,96,1,1
8475158,Ryan O'Reilly,STL,C,81,24,37,61,-23,2,230,3,15,8,23,48,42,0,4
8477939,William Nylander,TOR,RW,82,20,41,61,20,10,184,8,5,7,12,18,21,0,0
8474563,Drew Doughty,LAK,D,82,10,50,60,23,54,205,4,3,17,20,128,127,1,0
8477940,Nikolaj Ehlers,WPG,LW,82,29,31,60,14,26,231,7,7,6,13,27,39,0,0
8476460,Mark Scheifele,WPG,C,60,23,37,60,19,18,125,3,8,8,16,31,57,2,1
8475191,Reilly Smith,VGK,RW,67,22,38,60,31,24,162,4,7,7,14,24,40,1,1
8476792,Torey Krug,STL,D,76,14,45,59,0,36,197,4,5,19,24,73,79,1,0
8475168,Matt Duchene,NSH,C,82,27,32,59,-22,18,190,3,9,4,13,49,60,0,0
8474586,Jordan Eberle,NYI,RW,81,25,34,59,5,21,183,7,3,7,10,30,46,0,0
8474056,P.K. Subban,NJD,D,82,16,43,59,18,82,207,2,5,20,25,90,111,0,1
8475768,Jaden Schwartz,STL,LW,62,24,35,59,15,26,157,3,6,5,11,30,52,1,0
8476468,J.T. Miller,VAN,C,82,23,35,58,-4,40,143,5,11,7,18,26,124,0,0
8478398,Kyle Connor,WPG,LW,76,31,26,57,8,16,192,7,7,4,11,26,18,0,0
8475197,Tyson Barrie,EDM,D,68,14,43,57,-15,22,178,3,7,23,30,79,40,0,0
8477495,Seth Jones,CBJ,D,78,16,41,57,10,30,249,4,7,17,24,124,92,0,0
8474613,Derek Stepan,OTT,C,82,14,42,56,-7,26,209,2,3,15,18,54,52,2,0
8471735,Keith Yandle,FLA,D,82,8,48,56,7,35,179,1,1,17,18,101,26,0,2
8474884,Mike Hoffman,STL,C,82,22,34,56,-20,32,257,5,8,13,21,34,31,0,0
8475172,Nazem Kadri,COL,C,80,32,23,55,2,42,211,3,12,7,19,26,94,0,0
8475287,Erik Haula,NSH,LW,76,29,26,55,-16,37,175,4,11,8,19,42,85,0,0
8478444,Brock Boeser,VAN,RW,62,29,26,55,-5,16,179,4,10,13,23,24,29,0,0
8474565,Alex Pietrangelo,VGK,D,78,15,39,54,8,22,216,5,3,10,13,164,48,0,1
8475793,Ryan Johansen,NSH,C,79,15,39,54,13,78,129,3,1,14,15,35,87,0,2
8474037,James van Riemsdyk,PHI,LW,81,36,18,54,1,30,248,5,11,9,20,23,40,0,0
8475848,Brendan Gallagher,MTL,RW,82,31,23,54,-13,34,278,4,8,9,17,41,90,1,0
8475169,Evander Kane,SJS,LW,78,29,25,54,-9,82,307,2,3,6,9,34,159,4,0
8471669,Paul Stastny,WPG,C,82,16,37,53,1,18,159,3,3,6,9,38,43,0,1
8475692,Mats Zuccarello,MIN,RW,80,16,37,53,-10,36,178,3,1,16,17,67,62,0,0
8474600,Roman Josi,NSH,D,75,14,39,53,24,24,253,3,7,13,20,120,80,0,1
8473604,Jonathan Toews,CHI,C,74,20,32,52,-1,47,211,2,2,10,12,24,32,0,0
8474581,Jake Gardiner,CAR,D,82,5,47,52,9,32,133,0,1,14,15,103,51,0,0
8477951,Nick Schmaltz,ARI,C,78,21,31,52,1,18,118,2,4,9,13,39,13,0,2
8479337,Alex DeBrincat,CHI,LW,82,28,24,52,6,6,181,1,6,6,12,25,40,0,0
8476853,Morgan Rielly,TOR,D,76,6,46,52,-4,14,182,0,1,24,25,84,48,0,0
8476851,Alex Galchenyuk,OTT,LW,82,19,32,51,-31,22,213,2,9,15,24,37,33,0,0
8475225,Craig Smith,BOS,C,79,25,26,51,20,24,229,2,9,5,14,35,60,0,0
8471724,Kris Letang,PIT,D,79,9,42,51,-9,56,222,1,4,16,20,108,109,0,1
8474068,Kyle Turris,EDM,C,76,16,35,51,19,26,145,0,7,14,21,35,21,0,0
8470600,Ryan Suter,MIN,D,78,6,45,51,-1,34,149,2,1,22,23,138,78,0,1
8476856,Matt Dumba,MIN,D,82,14,36,50,15,41,176,4,2,10,12,112,136,0,1
8474870,Tyler Johnson,TBL,C,81,21,29,50,3,24,186,3,4,9,13,47,48,2,0
8474641,Adam Henrique,ANA,C,81,24,26,50,11,20,151,8,6,7,13,61,61,1,2
8477933,Sam Reinhart,BUF,RW,82,25,25,50,-24,26,188,5,12,9,21,42,48,0,0
8479314,Matthew Tkachuk,CGY,LW,68,24,25,49,-1,61,188,2,10,7,17,16,80,0,0
8471887,Patric Hornqvist,FLA,RW,70,29,20,49,2,58,247,1,15,7,22,64,137,0,0
8475784,Jeff Skinner,BUF,LW,82,24,25,49,-27,34,277,2,4,5,9,24,35,0,0
8475760,Nick Bjugstad,MIN,C,82,19,30,49,5,41,230,1,1,6,7,19,95,0,0
8470621,Corey Perry,MTL,RW,71,17,32,49,-4,71,168,1,4,7,11,36,59,0,0
8477511,Anthony Mantha,DET,RW,80,24,24,48,-1,52,190,2,9,3,12,36,91,0,0
8479400,Pierre-Luc Dubois,WPG,LW,82,20,28,48,8,49,165,4,6,9,15,46,127,0,0
8476480,Vladislav Namestnikov,DET,C,81,22,26,48,6,45,155,2,9,7,16,44,79,0,0
8477404,Jake Guentzel,PIT,LW,82,22,26,48,-9,42,171,1,7,5,12,46,142,0,0
8476454,Ryan Nugent-Hopkins,EDM,C,62,24,24,48,10,20,151,2,4,5,9,39,44,2,1
8477942,Kevin Fiala,MIN,LW,80,23,25,48,20,26,187,4,4,9,13,27,34,0,0
8478046,Danton Heinen,ANA,LW,77,16,31,47,10,16,135,4,2,10,12,33,45,1,0
8478439,Travis Konecny,PHI,RW,81,24,23,47,17,46,177,6,1,2,3,53,97,0,0
8475726,Tyler Toffoli,MTL,C,82,24,23,47,9,16,251,6,6,6,12,17,75,0,0
8471698,T.J. Oshie,WSH,RW,74,18,29,47,2,31,127,3,9,9,18,54,124,0,0
8466139,Patrick Marleau,SJS,C,82,27,20,47,1,16,203,5,5,4,9,26,85,0,0
8476459,Mika Zibanejad,NYR,C,72,27,20,47,-23,14,212,4,14,7,21,64,92,0,1
8473986,Alex Killorn,TBL,LW,82,15,32,47,22,45,156,1,2,7,9,25,82,0,0
8473544,Derick Brassard,ARI,C,72,21,25,46,0,34,197,3,5,1,6,25,96,0,0
8474715,Cam Atkinson,CBJ,RW,65,24,22,46,19,14,231,5,3,7,10,29,32,1,0
8476881,Tomas Hertl,SJS,C,79,22,24,46,-2,41,175,5,6,6,12,71,84,1,2
8477494,Jonathan Drouin,MTL,LW,77,13,33,46,-28,30,164,4,4,18,22,27,55,0,0
8473533,Jordan Staal,CAR,C,79,19,27,46,-4,26,160,2,4,8,12,32,181,2,0
8474190,Wayne Simmonds,TOR,RW,75,24,22,46,-16,57,176,5,11,6,17,54,129,1,0
8474150,Mikael Backlund,CGY,C,82,14,31,45,-21,78,214,2,3,8,11,40,54,1,2
8477503,Max Domi,CBJ,C,82,9,36,45,-7,73,150,0,1,8,9,28,49,0,0
8477355,Will Butcher,NJD,D,81,5,39,44,1,8,88,1,3,20,23,62,21,0,0
8475151,Kyle Palmieri,NJD,RW,62,24,20,44,-1,30,181,5,11,12,23,50,94,0,0
8477500,Bo Horvat,VAN,C,64,22,22,44,-1,10,158,3,10,3,13,29,35,1,0
8475763,Kevin Hayes,PHI,C,76,25,19,44,1,18,172,4,6,2,8,36,40,2,0
8473449,Kyle Okposo,BUF,RW,76,15,29,44,-34,40,161,2,6,15,21,34,70,0,0
8471276,David Krejci,BOS,C,64,17,27,44,10,18,119,2,7,6,13,35,31,0,0
8471707,James Neal,EDM,LW,71,25,19,44,-11,24,202,6,5,4,9,30,44,0,0
8477496,Elias Lindholm,CGY,C,81,16,28,44,-8,18,153,4,6,3,9,41,98,0,1
8476462,Dougie Hamilton,CAR,D,82,17,27,44,1,64,270,4,6,6,12,80,83,0,0
8477021,Alexander Kerfoot,TOR,C,79,19,24,43,-7,28,81,0,5,12,17,35,42,0,0
8478498,Jake DeBrusk,BOS,LW,70,16,27,43,13,19,143,5,2,7,9,26,70,0,0
8474034,Pat Maroon,TBL,LW,74,17,26,43,1,73,141,4,1,6,7,14,150,0,0
8473412,Bryan Little,WPG,C,82,16,27,43,2,28,129,2,2,10,12,33,50,0,0
8477402,Pavel Buchnevich,NYR,RW,74,14,29,43,-3,20,136,4,5,12,17,35,51,0,0
8475098,Tyler Bozak,STL,C,81,11,32,43,6,28,154,2,3,10,13,28,43,0,0
8475181,Nick Leddy,NYI,D,80,10,32,42,-42,20,153,1,4,10,14,104,95,0,0
8474162,Jake Muzzin,TOR,D,74,8,34,42,10,40,154,1,4,10,14,123,170,0,1
8473507,Jeff Petry,MTL,D,82,12,30,42,-30,28,178,2,6,17,23,138,167,0,0
8475171,Oliver Ekman-Larsson,ARI,D,82,14,28,42,-28,44,202,3,6,9,15,79,160,0,0
8476525,Colin Miller,BUF,D,82,10,31,41,-4,53,177,2,5,12,17,64,165,0,1
8477499,Rasmus Ristolainen,BUF,D,73,6,35,41,-25,48,182,1,1,22,23,111,206,0,0
8478500,Ivan Provorov,PHI,D,82,17,24,41,17,20,203,2,2,3,5,169,148,0,0
8474062,Riley Nash,CBJ,C,76,15,26,41,16,18,113,1,2,1,3,67,86,0,0
8476288,Ryan Dzingel,CAR,C,79,23,18,41,-17,35,136,2,4,4,8,19,60,0,0
8475786,Zach Hyman,TOR,LW,82,15,25,40,22,37,148,2,0,0,0,55,117,1,1
8478099,Kevin Labanc,SJS,RW,77,11,29,40,-6,32,156,3,4,13,17,23,31,0,0
8476871,Tanner Pearson,VAN,LW,82,15,25,40,11,27,180,4,2,3,5,36,116,0,0
8476919,Chris Tierney,OTT,C,82,17,23,40,0,8,118,2,3,4,7,45,26,2,2
8479410,Mikhail Sergachev,TBL,D,79,9,31,40,11,38,141,5,3,13,16,64,90,0,0
8475164,Jakob Silfverberg,ANA,RW,77,17,23,40,6,18,187,2,2,6,8,61,52,1,1
8477416,Oliver Bjorkstrand,CBJ,RW,82,11,29,40,4,9,163,2,3,6,9,43,64,0,0
8473618,Mathieu Perreault,WPG,LW,70,17,22,39,4,38,139,2,6,8,14,25,120,0,1
8474189,Lars Eller,WSH,C,81,18,20,38,-6,38,161,2,3,3,6,69,71,0,0
8475810,Bryan Rust,PIT,RW,69,13,25,38,11,26,123,3,2,2,4,40,97,2,1
8477932,Aaron Ekblad,FLA,D,82,16,22,38,9,71,189,4,5,6,11,121,69,0,0
8478131,Ondrej Kase,BOS,RW,66,20,18,38,18,14,146,5,1,2,3,26,28,0,0
8470966,Mark Giordano,CGY,D,82,13,25,38,0,63,214,4,1,9,10,161,93,1,0
8478585,Derek Ryan,CGY,C,80,15,23,38,-15,28,135,1,3,4,7,27,52,0,0
8471262,Carl Soderberg,CHI,C,77,16,21,37,0,26,150,3,3,2,5,64,71,0,1
8474157,Max Pacioretty,VGK,LW,64,17,20,37,-16,30,212,4,6,9,15,27,118,1,0
8478460,Zach Werenski,CBJ,D,77,16,21,37,8,16,207,3,3,7,10,92,58,0,0
8475184,Chris Kreider,NYR,LW,58,16,21,37,-2,44,137,0,7,5,12,24,103,0,0
8477960,Adrian Kempe,LAK,C,81,16,21,37,11,49,119,3,1,4,5,18,91,0,0
8474716,Jared Spurgeon,MIN,D,61,9,28,37,-6,8,110,2,3,10,13,127,64,0,0
8476312,Josh Manson,ANA,D,80,7,30,37,34,62,117,2,0,0,0,99,180,0,1
8475745,Charlie Coyle,BOS,C,66,11,26,37,8,18,117,1,0,3,3,63,76,1,0
8477949,Alex Tuch,VGK,RW,78,15,22,37,3,27,171,4,4,6,10,42,99,0,0
8477989,Christian Dvorak,ARI,C,78,15,22,37,-19,22,151,2,2,5,7,48,92,0,0
8478414,Timo Meier,SJS,RW,81,21,15,36,2,51,210,4,3,1,4,48,105,0,0
8474574,Tyler Myers,VAN,D,82,6,30,36,9,48,150,3,3,14,17,119,68,1,0
8477220,Nate Schmidt,VAN,D,76,5,31,36,19,16,103,1,1,10,11,121,41,0,0
8478463,Anthony Beauvillier,NYI,LW,71,21,15,36,2,16,132,2,3,5,8,29,80,0,0
8466138,Joe Thornton,TOR,C,47,13,23,36,-9,38,75,1,7,11,18,18,32,0,0
8476292,Ondrej Palat,TBL,LW,56,11,24,35,16,6,109,0,4,5,9,48,80,1,0
8471699,Andrew Cogliano,DAL,C,80,12,23,35,18,41,175,1,0,0,0,31,80,3,1
8476438,Brandon Saad,COL,LW,82,18,17,35,-10,14,237,8,1,0,1,32,29,0,0
8475209,Richard Panik,WSH,RW,72,14,21,35,7,38,136,0,4,2,6,37,137,0,0
8479407,Jesper Bratt,NJD,LW,74,13,22,35,-16,18,100,2,4,8,12,22,44,1,1
8475714,Calle Jarnkrok,NSH,C,68,16,19,35,20,12,105,3,1,3,4,31,36,2,0
8477505,Alex Wennberg,FLA,C,66,8,27,35,22,12,74,2,3,2,5,46,28,0,1
8476892,Colton Parayko,STL,D,82,6,29,35,-7,13,212,0,2,7,9,141,120,0,0
8475754,Brock Nelson,NYI,C,82,19,16,35,-4,43,138,3,4,4,8,52,50,0,0
8476880,Tom Wilson,WSH,RW,78,14,21,35,10,187,123,1,0,1,1,51,250,1,0
8471274,Alex Goligoski,ARI,D,78,12,23,35,-31,26,119,3,3,8,11,154,114,0,0
8474038,Paul Byron,MTL,LW,82,20,15,35,-4,23,115,1,2,2,4,55,137,1,1
8475218,Mattias Ekholm,NSH,D,81,10,24,34,25,46,135,1,5,8,13,117,75,1,0
8476458,Ryan Strome,NYR,C,82,13,21,34,-4,33,147,3,2,4,6,17,43,0,1
8471260,Blake Comeau,DAL,LW,79,13,21,34,5,50,123,3,0,0,0,38,145,3,0
8473473,Milan Lucic,CGY,LW,82,10,24,34,-12,80,147,1,3,4,7,25,254,0,0
8471303,Alexander Edler,VAN,D,70,6,28,34,-18,68,172,2,1,14,15,203,157,0,0
8475193,Tomas Tatar,MTL,LW,82,20,14,34,-19,34,174,4,9,4,13,29,67,0,0
8477406,Mattias Janmark,CHI,C,81,19,15,34,-13,24,136,4,4,1,5,41,15,2,0
8470655,David Backes,ANA,RW,57,14,19,33,2,53,160,1,2,4,6,25,137,0,1
8475855,Jesper Fast,CAR,RW,71,13,20,33,-10,26,80,0,0,0,0,44,130,0,2
8476889,Radek Faksa,DAL,C,79,17,16,33,21,36,118,3,0,0,0,56,101,2,0
8471676,Bobby Ryan,DET,RW,62,11,22,33,-12,14,112,1,1,3,4,52,97,0,0
8470144,Frans Nielsen,DET,C,79,16,17,33,1,14,134,3,4,3,7,62,49,2,1
8473422,Nick Foligno,CBJ,LW,72,15,18,33,1,50,137,1,2,2,4,60,182,0,0
8470047,Valtteri Filppula,DET,C,81,11,22,33,-7,20,70,4,3,1,4,55,25,0,2
8474027,Justin Braun,PHI,D,81,5,28,33,7,28,115,0,0,0,0,152,143,0,0
8478432,Christian Fischer,ARI,RW,79,15,18,33,-17,14,154,3,5,3,8,23,109,0,0
8475799,Nino Niederreiter,CAR,RW,63,18,14,32,14,36,133,4,7,1,8,20,58,0,0
8471709,Marc-Edouard Vlasic,SJS,D,81,11,21,32,9,34,161,2,1,2,3,174,26,0,1
8478396,Noah Hanifin,CGY,D,79,10,22,32,-20,21,165,3,1,6,7,69,81,0,0
8476432,Boone Jenner,CBJ,C,75,13,19,32,1,39,187,2,2,1,3,83,205,0,0
8475820,Joonas Donskoi,COL,RW,66,14,18,32,10,26,129,2,1,4,5,28,28,0,0
8470281,Duncan Keith,CHI,D,82,2,30,32,-29,28,187,1,2,8,10,165,41,0,0
8475222,Sami Vatanen,NJD,D,72,4,28,32,-7,40,145,0,1,12,13,105,92,0,1
8474673,TJ Brodie,TOR,D,73,4,28,32,-16,18,118,0,1,10,11,99,24,0,0
8476913,Devin Shore,EDM,C,82,11,21,32,-30,14,123,1,2,9,11,57,71,1,1
8475764,Cam Fowler,ANA,D,67,8,24,32,3,28,122,1,1,9,10,108,21,1,1
8479325,Charlie McAvoy,BOS,D,63,7,25,32,20,53,77,2,2,5,7,80,133,0,0
8477506,Ryan Pulock,NYI,D,68,10,22,32,-4,14,184,0,5,6,11,86,113,0,0
8477425,Miles Wood,NJD,LW,76,19,13,32,-6,84,170,2,3,0,3,22,75,0,0
8475176,Ryan Ellis,NSH,D,44,9,23,32,26,6,110,2,2,3,5,84,27,0,3
8475772,Riley Sheahan,BUF,C,81,11,21,32,4,8,109,1,1,1,2,50,52,0,1
8477986,Brandon Montour,BUF,D,80,9,23,32,16,42,160,5,5,7,12,83,96,1,1
8477451,Ryan Hartman,MIN,RW,78,11,20,31,1,72,129,2,1,1,2,38,113,0,0
8475200,Dmitry Orlov,WSH,D,82,10,21,31,10,22,125,2,0,4,4,116,128,0,0
8473573,Artem Anisimov,OTT,C,72,20,11,31,-17,22,130,6,11,1,12,40,15,1,0
8476854,Hampus Lindholm,ANA,D,69,13,18,31,16,34,131,3,3,5,8,97,93,0,0
8471794,Darren Helm,DET,LW,75,13,18,31,3,39,141,0,0,0,0,36,131,2,2
8476437,Victor Rask,MIN,C,71,14,17,31,0,12,126,3,4,7,11,29,62,0,0
8474176,Carl Hagelin,WSH,LW,81,10,21,31,8,28,169,2,0,0,0,36,112,1,1
8474040,Sam Gagner,DET,C,74,10,21,31,-18,35,164,2,3,8,11,28,54,0,0
8475753,Justin Faulk,STL,D,76,8,23,31,-26,48,211,3,3,16,19,90,128,0,0
8477839,Conor Sheary,WSH,LW,79,18,12,30,2,10,142,4,2,1,3,31,29,0,0
8476958,Jaccob Slavin,CAR,D,82,8,22,30,1,10,154,1,1,1,2,154,47,0,0
8476934,Brock McGinn,CAR,LW,80,16,14,30,-12,22,159,1,2,1,3,17,137,1,0
8479974,Nolan Patrick,PHI,C,73,13,17,30,1,30,127,2,5,3,8,19,48,0,0
8476981,Josh Anderson,MTL,RW,63,19,11,30,-1,42,188,5,1,3,4,24,109,0,0
8474151,Ryan McDonagh,TBL,D,63,4,25,29,8,20,99,0,1,8,9,163,71,0,1
8476469,Joel Armia,MTL,RW,79,12,17,29,3,22,128,2,0,4,4,39,86,1,1
8476419,Jean-Gabriel Pageau,NYI,C,78,14,15,29,-14,36,147,2,1,1,2,69,131,1,0
8477447,Shea Theodore,VGK,D,61,6,23,29,5,14,144,1,1,8,9,70,29,0,0
8476874,Olli Maatta,LAK,D,82,7,22,29,-1,28,164,3,0,8,8,115,131,0,0
8477429,Andrew Copp,WPG,C,82,9,19,28,17,14,96,0,0,0,0,51,99,2,1
8476918,Jimmy Vesey,TOR,LW,79,17,11,28,-18,20,136,4,1,2,3,34,83,0,0
8477955,Jared McCann,PIT,C,68,9,19,28,11,30,143,4,1,0,1,32,43,0,1
8477015,Connor Brown,OTT,RW,82,14,14,28,0,18,119,2,1,1,2,28,23,1,0
8475792,Brett Connolly,FLA,RW,70,15,12,27,-6,30,67,2,4,1,5,24,72,0,0
8476925,Colton Sissons,NSH,C,81,9,18,27,2,42,120,4,1,6,7,49,136,0,3
8475752,Tyler Pitlick,ARI,C,80,14,13,27,9,34,129,2,0,0,0,57,122,0,1
8474602,Justin Schultz,WSH,D,63,4,23,27,22,14,109,1,0,10,10,93,36,0,0
8477944,Jakub Vrana,WSH,LW,73,13,14,27,2,12,133,2,1,2,3,16,31,0,0
8476875,Mike Matheson,PIT,D,81,10,17,27,-1,61,167,2,1,3,4,137,53,0,1
8477941,Nick Ritchie,BOS,LW,76,10,17,27,3,72,122,2,1,2,3,27,221,0,0
8475236,Cody Eakin,BUF,C,80,11,16,27,-6,22,107,2,0,0,0,45,63,1,2
8476902,Esa Lindell,DAL,D,80,7,20,27,19,24,137,0,2,6,8,123,92,0,0
8476474,Stefan Noesen,SJS,RW,72,13,14,27,12,36,127,4,0,0,0,41,112,0,0
8477498,Darnell Nurse,EDM,D,82,6,20,26,15,67,194,2,0,0,0,153,161,0,0
8477504,Josh Morrissey,WPG,D,81,7,19,26,15,47,102,0,0,1,1,168,139,0,0
8469455,Jason Spezza,TOR,C,78,8,18,26,-12,12,138,3,4,7,11,26,16,0,0
8473453,Trevor Lewis,WPG,C,68,14,12,26,-6,25,134,3,1,2,3,32,125,2,0
8477935,Sam Bennett,CGY,C,82,11,15,26,-18,59,157,1,1,2,3,34,140,0,0
8470607,Brent Seabrook,CHI,D,81,7,19,26,-3,38,136,0,2,6,8,170,85,0,0
8474091,Brandon Sutter,VAN,C,61,11,15,26,8,8,106,1,0,0,0,32,55,0,4
8476442,Matt Nieto,SJS,LW,74,15,11,26,6,14,84,1,0,0,0,56,27,1,0
8478401,Pavel Zacha,NJD,C,69,8,17,25,-3,30,112,0,2,3,5,22,70,1,0
8478469,Thomas Chabot,OTT,D,63,9,16,25,-12,14,94,0,0,8,8,64,44,0,0
8476994,Vinnie Hinostroza,FLA,C,50,7,18,25,5,10,86,1,1,4,5,17,26,0,0
8476399,Blake Coleman,TBL,C,79,13,12,25,7,50,146,2,0,0,0,57,216,3,0
8476479,Phillip Danault,MTL,C,52,8,17,25,0,34,94,2,0,2,2,38,59,1,0
8477444,Andre Burakovsky,COL,LW,56,12,13,25,3,27,84,5,2,2,4,26,40,0,0
8478542,Evan Rodrigues,PIT,C,48,7,18,25,-10,14,91,0,1,5,6,23,19,0,0
8474009,Nick Bonino,MIN,C,71,12,13,25,4,20,83,0,0,0,0,72,18,0,0
8476869,Brady Skjei,CAR,D,82,4,21,25,-27,39,153,1,0,6,6,119,127,1,0
8476924,Martin Frk,LAK,RW,68,11,14,25,-14,14,99,0,5,4,9,10,77,0,0
8480113,Alex Iafallo,LAK,LW,75,9,16,25,10,12,129,1,0,2,2,33,53,0,0
8476356,Tobias Rieder,BUF,LW,78,12,13,25,-12,6,114,0,2,1,3,41,96,0,0
8476873,Mark Jankowski,PIT,C,72,17,8,25,-7,33,118,3,2,1,3,51,35,2,0
8474066,Thomas Hickey,NYI,D,69,5,20,25,20,24,87,0,0,0,0,110,76,0,0
8474166,Alec Martinez,VGK,D,77,9,16,25,3,34,111,0,2,9,11,206,100,0,1
8473564,Michael Frolik,MTL,RW,70,10,15,25,-19,26,167,1,0,0,0,35,48,2,0
8473446,Erik Johnson,COL,D,62,9,16,25,3,58,168,3,0,3,3,135,114,0,1
8477479,Tyler Bertuzzi,DET,LW,48,7,17,24,-7,39,83,1,1,1,2,38,53,0,0
8474683,Derek Grant,ANA,C,66,12,12,24,3,11,65,0,3,0,3,39,63,0,1
8476923,Damon Severson,NJD,D,76,9,15,24,-8,42,121,2,0,4,4,62,107,0,0
8465009,Zdeno Chara,WSH,D,73,7,17,24,22,60,144,3,0,0,0,118,141,0,1
8478407,Vince Dunn,STL,D,75,5,19,24,1,20,138,1,2,7,9,59,29,0,0
8474685,Matt Calvert,COL,LW,69,9,15,24,-10,33,108,0,1,0,1,35,61,2,0
8476885,Jacob Trouba,NYR,D,55,3,21,24,9,34,144,2,0,3,3,100,84,0,1
8474098,Colton Sceviour,PIT,C,76,11,13,24,6,24,141,2,0,0,0,69,84,1,2
8470610,Zach Parise,MIN,LW,42,15,9,24,0,14,119,4,2,1,3,37,26,0,0
8479398,Samuel Girard,COL,D,73,4,19,23,-11,8,84,0,1,12,13,69,46,0,0
8477456,J.T. Compher,COL,LW,69,13,10,23,-29,20,131,3,4,3,7,65,45,2,0
8474031,Kevin Shattenkirk,ANA,D,46,5,18,23,-14,44,94,1,2,10,12,65,44,0,0
8478906,Markus Nutivaara,FLA,D,61,7,16,23,13,14,79,1,1,1,2,40,42,0,0
8475220,Marcus Foligno,MIN,LW,77,8,15,23,2,72,79,2,1,1,2,44,185,0,0
8470626,Loui Eriksson,VAN,LW,50,10,13,23,0,4,101,0,0,3,3,30,7,1,1
8477407,Anthony Duclair,FLA,LW,56,11,12,23,-5,16,97,2,3,0,3,26,46,0,0
8475455,Brenden Dillon,WSH,D,81,5,17,22,-7,60,88,0,0,0,0,107,197,0,0
8474584,Michael Del Zotto,CBJ,D,82,6,16,22,-8,48,128,0,0,5,5,127,244,0,0
8470604,Jeff Carter,LAK,C,27,13,9,22,4,2,85,2,6,3,9,11,27,1,0
8474589,Tyler Ennis,EDM,C,73,8,14,22,-1,12,115,3,2,1,3,33,51,0,0
8479370,Tyson Jost,COL,C,65,12,10,22,-10,26,113,1,5,3,8,26,33,0,0
8477947,Sonny Milano,ANA,LW,55,14,8,22,-8,10,69,3,0,4,4,11,28,0,0
8477290,Michael Raffl,PHI,LW,76,13,9,22,9,28,96,3,1,0,1,50,90,0,0
8474618,Marco Scandella,STL,D,82,5,17,22,-15,37,138,1,0,4,4,114,91,0,1
8474291,Jay Beagle,VAN,C,79,7,15,22,3,16,65,2,0,0,0,44,69,1,0
8476988,Matt Benning,NSH,D,73,6,15,21,5,49,111,2,0,2,2,82,149,0,1
8476463,Jonas Brodin,MIN,D,73,6,15,21,23,30,77,1,0,3,3,139,34,0,0
8475246,Kevin Connauton,FLA,D,73,11,10,21,3,20,102,3,0,0,0,72,116,0,0
8476392,Adam Lowry,WPG,C,45,8,13,21,9,8,70,1,1,1,2,28,124,0,0
8477476,Artturi Lehkonen,MTL,LW,66,12,9,21,-11,20,164,3,3,1,4,23,71,1,0
8476915,Jujhar Khaira,EDM,LW,69,11,10,21,-7,47,73,2,0,1,1,39,128,1,1
8471729,Kris Russell,EDM,D,78,4,17,21,-7,8,90,0,0,2,2,223,97,0,0
8477507,Nikita Zadorov,CHI,D,77,7,13,20,4,103,94,1,0,1,1,106,278,0,0
8479344,Jesse Puljujarvi,EDM,RW,65,12,8,20,-1,14,136,2,2,0,2,23,67,0,0
8476381,Andrew Shaw,CHI,RW,51,10,10,20,-8,53,94,0,5,2,7,26,80,0,0
8479465,Drake Caggiula,ARI,C,67,13,7,20,-13,37,104,1,3,0,3,33,147,1,0
8474218,Jason Demers,ARI,D,69,6,14,20,-4,37,95,2,0,3,3,79,66,0,0
8476872,Scott Laughton,PHI,C,81,10,10,20,-10,42,108,0,0,0,0,27,126,1,0
8474013,Ian Cole,MIN,D,67,5,15,20,14,76,84,0,0,1,1,116,95,0,0
8476331,Dylan DeMelo,WPG,D,63,0,20,20,-1,34,67,0,0,3,3,70,75,0,0
8480172,Jan Rutta,TBL,D,57,6,14,20,-1,24,71,1,2,2,4,64,24,0,1
8477937,Jake Virtanen,VAN,RW,75,10,10,20,-11,46,130,1,0,0,0,29,156,0,0
8475178,Zack Kassian,EDM,RW,74,7,12,19,-8,92,86,0,0,1,1,9,129,0,2
8476393,Nick Cousins,NSH,C,71,12,7,19,-7,31,119,1,1,0,1,39,117,0,0
8476822,Luke Glendening,DET,C,69,11,8,19,-14,17,88,2,1,0,1,83,137,2,1
8475766,Austin Watson,OTT,LW,76,14,5,19,2,123,96,3,0,0,0,78,187,4,1
8476879,Cody Ceci,PIT,D,82,5,14,19,-27,12,143,1,0,5,5,171,163,0,0
8473463,Leo Komarov,NYI,RW,74,7,12,19,0,31,114,0,2,1,3,48,219,1,0
8474250,Zack Smith,CHI,C,68,5,14,19,-32,54,124,1,0,3,3,29,90,0,1
8476917,Adam Pelech,NYI,D,78,3,16,19,7,28,106,1,0,2,2,142,100,0,1
8477488,Brett Pesce,CAR,D,65,3,16,19,-6,18,88,1,0,0,0,101,57,0,0
8475762,Derek Forbort,WPG,D,78,1,17,18,18,49,78,0,0,0,0,156,142,0,0
8473504,Cal Clutterbuck,NYI,RW,76,8,10,18,-7,53,101,1,0,0,0,53,226,1,0
8476905,Chandler Stephenson,VGK,C,67,6,12,18,13,8,36,0,0,0,0,33,26,0,0
8470187,Johnny Boychuk,NYI,D,58,6,12,18,-8,30,141,3,2,0,2,112,114,0,0
8476779,Brad Hunt,MIN,D,45,3,15,18,-5,6,80,0,2,10,12,36,19,0,0
8471873,Anton Stralman,FLA,D,80,4,14,18,29,18,131,0,0,0,0,100,104,0,0
8476422,Mike Reilly,OTT,D,57,2,16,18,-5,26,65,0,0,6,6,37,41,0,0
8475208,Brian Dumoulin,PIT,D,80,5,13,18,-5,30,102,1,0,0,0,132,101,0,0
8475163,Alex Chiasson,EDM,RW,61,9,9,18,1,26,59,2,1,0,1,29,57,1,2
8475186,John Moore,BOS,D,81,7,11,18,3,47,141,2,0,2,2,105,135,1,0
8479293,Brandon Tanev,PIT,LW,61,8,10,18,13,18,79,1,0,0,0,56,188,3,0
8476467,Jamie Oleksiak,DAL,D,68,5,12,17,7,87,81,1,1,0,1,76,174,0,0
8474207,Nick Holden,VGK,D,73,4,13,17,-5,14,80,0,0,3,3,83,136,0,0
8475231,Casey Cizikas,NYI,C,64,7,10,17,-12,23,74,0,0,0,0,53,128,1,0
8475728,Johan Larsson,ARI,LW,80,4,13,17,-30,49,86,0,0,0,0,47,117,1,1
8470775,Nate Thompson,WPG,C,69,5,12,17,-1,20,53,0,0,0,0,39,122,1,0
8476441,Joel Edmundson,MTL,D,69,7,10,17,-1,57,124,0,0,0,0,150,116,0,0
8474849,Antoine Roussel,VAN,LW,73,5,12,17,1,126,85,0,0,0,0,42,104,0,0
8478493,Joel Eriksson Ek,MIN,C,75,6,10,16,2,22,124,0,0,0,0,46,134,0,0
8477901,Daniel Carr,WSH,LW,38,6,10,16,2,8,52,0,2,1,3,16,30,0,0
8477930,Pierre-Edouard Bellemare,COL,C,72,6,10,16,5,14,92,1,0,0,0,63,41,0,0
8477845,Trevor van Riemsdyk,WSH,D,79,3,13,16,9,20,111,1,0,0,0,113,25,0,0
8470642,Shea Weber,MTL,D,26,6,10,16,-8,14,75,1,2,3,5,59,66,0,1
8476979,Erik Gustafsson,PHI,D,35,5,11,16,1,6,71,0,0,4,4,45,30,0,0
8475796,Mark Pysyk,DAL,D,82,3,13,16,-8,20,106,0,0,0,0,123,102,0,0
8475462,Radko Gudas,FLA,D,70,2,14,16,0,83,142,0,0,0,0,123,170,0,1
8475233,David Savard,CBJ,D,81,4,12,16,2,32,145,0,0,0,0,143,144,0,1
8471273,Brandon Dubinsky,CBJ,C,62,6,10,16,-2,33,89,0,0,1,1,47,145,1,1
8476191,Kevan Miller,BOS,D,68,1,15,16,16,70,64,0,0,0,0,111,164,0,2
8475780,Chris Wagner,BOS,RW,79,7,9,16,-10,37,93,0,1,2,3,49,253,2,0
8470755,Brad Richardson,NSH,RW,76,3,12,15,-24,45,105,0,0,0,0,52,72,0,0
8475188,Brayden McNabb,VGK,D,76,5,10,15,26,52,88,1,0,0,0,176,225,0,0
8476921,Jordan Martinook,CAR,LW,81,6,9,15,-24,45,112,1,0,0,0,42,128,0,1
8474818,Jordie Benn,VAN,D,77,4,11,15,-2,34,106,0,0,0,0,153,90,0,0
8475324,Nick Jensen,WSH,D,81,0,15,15,-8,27,107,0,0,1,1,88,71,0,0
8475747,Patrik Nemeth,DET,D,68,3,12,15,27,41,73,0,0,0,0,185,66,0,2
8475730,Stephen Johns,DAL,D,75,8,7,15,10,41,121,2,0,0,0,155,201,0,1
8476878,Zemgus Girgensons,BUF,LW,71,7,8,15,-12,26,113,0,0,0,0,32,134,2,0
8477931,Tomas Nosek,VGK,LW,67,7,8,15,6,14,92,0,0,0,0,24,53,1,1
8477846,Ryan Carpenter,CHI,C,52,9,6,15,1,11,85,2,0,0,0,17,76,1,0
8476891,Matt Grzelcyk,BOS,D,61,3,12,15,21,22,82,0,0,2,2,42,45,0,0
8477851,Jordan Oesterle,ARI,D,55,5,10,15,-11,8,99,0,1,2,3,97,62,0,0
8475149,Marcus Johansson,MIN,C,29,5,9,14,-11,14,42,0,1,2,3,9,8,0,0
8479345,Jakob Chychrun,ARI,D,50,4,10,14,2,16,102,1,2,2,4,72,74,0,0
8475279,Ben Chiarot,MTL,D,57,2,12,14,15,32,57,0,0,0,0,75,105,0,0
8480145,Neal Pionk,WPG,D,28,1,13,14,-1,12,54,0,0,5,5,41,49,0,0
8476439,Brett Ritchie,CGY,RW,71,7,7,14,1,42,117,0,2,1,3,10,172,0,0
8478458,Jack Roslovic,CBJ,C,31,5,9,14,5,2,38,1,0,0,0,9,20,0,0
8476374,Sean Kuraly,BOS,C,75,6,8,14,-5,40,134,1,0,0,0,22,143,0,1
8475235,Nicolas Deslauriers,ANA,LW,58,10,4,14,7,55,77,1,0,0,0,30,238,0,1
8477043,Christian Djoos,DET,D,63,3,11,14,13,10,60,0,0,0,0,55,22,0,0
8474579,Luca Sbisa,NSH,D,30,2,12,14,8,15,26,0,0,0,0,54,50,0,1
8476473,Connor Murphy,CHI,D,76,2,12,14,-3,34,109,0,0,0,0,101,138,0,0
8476624,Barclay Goodrow,TBL,C,47,7,7,14,1,28,57,1,0,0,0,30,68,1,0
8476457,Adam Larsson,EDM,D,63,4,9,13,10,34,92,1,0,0,0,140,239,0,0
8478055,Gustav Forsling,FLA,D,41,3,10,13,-2,8,82,1,1,3,4,56,26,0,1
8474145,Robert Bortuzzo,STL,D,72,4,9,13,11,41,76,1,0,0,0,108,121,0,0
8478408,Travis Dermott,TOR,D,37,1,12,13,16,8,54,0,0,0,0,36,48,0,0
8474688,Greg Pateryn,COL,D,73,1,12,13,6,50,100,0,0,0,0,148,155,0,0
8472382,Andy Greene,NYI,D,81,3,10,13,-9,21,93,0,0,0,0,188,84,0,0
8477903,Garnet Hathaway,WSH,RW,59,4,9,13,3,88,68,0,0,0,0,32,154,1,0
8479458,Nikita Zaitsev,OTT,D,60,5,8,13,8,31,54,1,0,0,0,134,113,0,0
8477401,John Hayden,ARI,C,47,4,9,13,-4,54,56,0,0,0,0,23,118,1,0
8477964,Ivan Barbashev,STL,C,53,7,6,13,-1,4,45,1,0,0,0,25,70,0,0
8476858,Phillip Di Giuseppe,NYR,LW,49,5,8,13,0,17,64,1,0,0,0,14,88,0,0
8474709,Matt Martin,NYI,LW,50,3,9,12,0,50,46,0,0,0,0,9,147,0,0
8476941,Connor Carrick,NJD,D,47,4,8,12,5,27,55,3,1,1,2,53,42,0,0
8478075,Anders Bjork,BOS,LW,30,4,8,12,2,6,30,0,2,1,3,11,19,0,0
8476931,Jake McCabe,BUF,D,53,3,9,12,-11,26,53,0,1,0,1,79,110,0,0
8476429,Scott Mayfield,NYI,D,47,2,10,12,-6,45,58,0,0,0,0,73,77,0,0
8477215,Danny DeKeyser,DET,D,65,6,6,12,2,28,65,0,0,0,0,125,76,0,0
8477455,Jacob de la Rose,STL,LW,55,4,8,12,-2,29,53,0,0,0,0,36,127,1,0
8476850,Ryan Murray,NJD,D,44,1,11,12,4,8,34,0,0,0,0,75,31,0,0
8477474,Madison Bowey,CHI,D,51,0,12,12,-3,24,47,0,0,0,0,42,48,0,0
8475177,Calvin de Haan,CHI,D,33,1,11,12,11,8,44,0,0,0,0,65,45,0,0
8477508,Curtis Lazar,BUF,C,65,2,10,12,-8,23,65,1,0,0,0,26,130,0,0
8478866,Dominik Simon,CGY,C,33,4,8,12,2,16,36,0,0,0,0,18,37,0,0
8480144,David Kampf,CHI,C,46,4,7,11,-9,12,46,0,0,0,0,23,29,0,0
8474612,Travis Hamonic,VAN,D,74,1,10,11,-9,79,107,0,0,0,0,124,83,0,0
8474697,Mark Borowiecki,NSH,D,52,3,8,11,-6,64,66,0,0,0,0,81,226,0,0
8475690,Christopher Tanev,CGY,D,42,2,9,11,7,8,31,0,0,0,0,70,21,0,2
8475179,Dmitry Kulikov,NJD,D,62,3,8,11,6,22,48,1,0,0,0,78,69,0,0
8478519,Anthony Cirelli,TBL,C,18,5,6,11,11,6,26,0,0,0,0,6,17,0,1
8478569,Noel Acciari,FLA,C,60,10,1,11,-6,9,66,0,0,0,0,41,152,1,0
8479442,Troy Stecher,DET,D,68,1,10,11,-7,35,94,0,0,1,1,75,111,0,1
8476326,Josh Archibald,EDM,RW,42,5,6,11,-2,25,42,0,0,0,0,16,86,0,0
8471677,Jack Johnson,NYR,D,77,3,8,11,-6,22,88,1,0,0,0,135,101,0,0
8476966,Gemel Smith,TBL,C,46,6,5,11,5,17,42,0,0,0,0,13,33,0,0
8480158,Andreas Borgman,TBL,D,48,3,8,11,4,28,46,0,0,0,0,36,121,0,0
8475278,Byron Froese,CGY,C,48,3,8,11,0,26,49,0,0,0,0,42,54,0,0
8479482,Michal Kempny,WSH,D,53,3,7,10,14,26,82,0,0,0,0,82,57,0,0
8476430,Tomas Jurco,VGK,RW,29,6,4,10,1,12,44,1,0,0,0,12,22,0,0
8477948,Travis Sanheim,PHI,D,49,2,8,10,-6,20,72,0,0,0,0,35,27,0,0
8475160,Kyle Clifford,STL,LW,50,6,4,10,-4,48,81,0,0,0,0,8,127,0,0
8478366,Frank Vatrano,FLA,C,41,7,3,10,3,34,72,0,0,0,0,15,51,0,0
8471817,Ryan Reaves,VGK,RW,79,4,6,10,-7,94,42,1,0,0,0,27,236,0,0
8477462,Robert Hagg,PHI,D,70,3,6,9,5,32,89,0,0,0,0,100,238,0,0
8474230,Micheal Haley,OTT,LW,75,3,6,9,-13,212,55,1,0,0,0,23,124,0,0
8476470,Nathan Beaulieu,WPG,D,59,1,8,9,-19,36,67,0,0,1,1,65,45,0,0
8478440,Dylan Strome,CHI,C,21,4,5,9,4,8,30,0,1,0,1,12,7,0,0
8474125,Carl Gunnarsson,STL,D,63,5,4,9,15,22,59,2,0,0,0,102,35,0,0
8471769,Niklas Hjalmarsson,ARI,D,48,1,8,9,-3,18,32,0,0,1,1,118,16,0,0
8479420,Tage Thompson,BUF,RW,41,3,6,9,-12,12,55,0,0,1,1,9,39,0,0
8476975,Cedric Paquette,OTT,C,56,5,4,9,-5,41,64,2,0,1,1,32,112,0,0
8477987,Ryan Donato,SJS,C,12,5,4,9,2,2,24,0,2,2,4,2,6,0,0
8477953,Kasperi Kapanen,PIT,RW,38,7,2,9,-1,4,55,1,0,0,0,9,57,1,0
8476886,Slater Koekkoek,EDM,D,35,4,4,8,4,18,43,1,0,0,0,24,36,0,0
8478020,Michael Amadio,LAK,C,37,4,4,8,-2,8,28,0,1,2,3,9,18,0,0
8477346,MacKenzie Weegar,FLA,D,60,2,6,8,5,32,58,0,0,0,0,69,108,0,0
8474090,Brendan Smith,NYR,D,44,1,7,8,2,69,66,0,0,1,1,37,58,0,0
8475625,Matt Irwin,BUF,D,50,2,6,8,2,8,62,0,0,0,0,54,78,0,0
8471284,Andrej Sekera,DAL,D,36,0,8,8,-15,6,36,0,0,2,2,42,27,0,0
8471686,Marc Staal,DET,D,72,1,7,8,11,18,68,0,0,0,0,96,76,0,0
8476967,Brett Kulak,MTL,D,71,2,6,8,-3,27,73,0,0,0,0,49,45,0,0
8477938,Haydn Fleury,CAR,D,67,0,8,8,-2,14,86,0,0,0,0,94,85,0,0
8474568,Luke Schenn,TBL,D,64,1,6,7,-12,35,59,1,0,0,0,105,219,0,0
8477353,Tyler Motte,VAN,C,46,5,2,7,-4,6,64,0,0,0,0,27,93,0,0
8474736,Zac Rinaldo,CGY,C,53,5,2,7,-7,44,56,0,0,0,0,23,188,0,0
8479376,Victor Mete,MTL,D,49,0,7,7,5,4,43,0,0,4,4,71,1,0,0
8475807,Joakim Nordstrom,CGY,C,75,2,5,7,-11,6,97,0,0,0,0,41,107,0,0
8475869,Brandon Davidson,BUF,D,51,4,3,7,-13,23,63,0,0,0,0,89,105,0,1
8475834,Marcus Sorensen,SJS,LW,32,5,2,7,-5,5,25,1,0,0,0,15,26,0,0
8478067,Oskar Lindblom,PHI,LW,23,2,4,6,4,8,36,1,0,1,1,13,27,0,0
8478400,Colin White,OTT,C,21,2,4,6,1,8,24,1,0,0,0,15,12,0,0
8477018,Ben Hutton,ANA,D,61,0,6,6,-9,23,103,0,0,2,2,68,40,0,1
8478443,Brandon Carlo,BOS,D,76,0,6,6,10,45,76,0,0,0,0,84,89,0,1
8477527,Ross Johnston,NYI,LW,24,3,3,6,0,62,19,0,0,0,0,11,46,0,0
8479968,Vinni Lettieri,ANA,C,19,1,4,5,-12,0,28,0,0,1,1,6,22,0,0
8479999,Casey Mittelstadt,BUF,C,6,1,4,5,1,2,9,0,1,0,1,2,2,0,0
8477240,Carter Rowney,ANA,C,44,2,3,5,-13,4,21,0,0,0,0,24,74,1,0
8475790,Erik Gudbranson,OTT,D,52,2,3,5,-7,35,53,0,0,0,0,81,126,0,0
8476285,Matthew Peca,OTT,C,10,2,3,5,6,0,17,0,0,0,0,8,11,0,0
8477244,Chad Ruhwedel,PIT,D,44,2,3,5,-8,16,67,0,0,0,0,43,67,0,0
8476449,Scott Harrington,CBJ,D,32,2,3,5,0,8,28,1,0,0,0,44,35,0,1
8474134,Yannick Weber,PIT,D,47,2,3,5,2,16,40,0,0,0,0,35,47,0,0
8476897,Oskar Sundqvist,STL,C,42,1,4,5,-5,14,41,0,0,0,0,14,47,0,0
8476323,Max McCormick,CAR,LW,30,3,2,5,-5,37,33,0,0,0,0,8,56,0,0
8478451,Ethan Bear,EDM,D,18,1,3,4,-11,10,20,0,1,1,2,28,14,0,0
8480222,Sebastian Aho,NYI,D,22,1,3,4,-5,6,24,0,1,0,1,14,10,0,0
8479316,Luke Kunin,NSH,C,19,2,2,4,-3,13,32,0,0,0,0,8,34,1,0
8477969,Marcus Pettersson,PIT,D,22,1,3,4,5,6,16,0,0,1,1,27,18,0,0
8477073,Kurtis MacDermid,LAK,D,34,1,3,4,-4,57,19,0,0,0,0,27,77,0,0
8478073,Anton Lindholm,CHI,D,48,0,4,4,4,14,22,0,0,0,0,51,99,0,0
8478567,Dean Kukan,CBJ,D,11,0,4,4,2,2,12,0,0,0,0,10,2,0,0
8476410,Josh Leivo,CGY,LW,16,1,3,4,0,6,25,0,0,0,0,5,2,0,0
8477473,Justin Bailey,VAN,RW,12,3,1,4,-2,2,19,0,0,0,0,9,19,0,0
8475343,Nic Dowd,WSH,C,56,3,1,4,-10,28,51,1,1,0,1,30,81,0,0
8478488,Filip Chlapik,OTT,C,20,1,3,4,-5,4,21,0,0,1,1,14,19,0,0
8477454,Adam Erne,DET,LW,23,3,1,4,-1,11,29,1,0,0,0,8,37,0,0
8478454,Noah Juulsen,FLA,D,23,1,2,3,1,4,33,0,0,0,0,34,58,0,0
8475750,Jon Merrill,DET,D,34,1,2,3,7,22,30,1,0,0,0,42,35,0,0
8480078,Filip Chytil,NYR,C,9,1,2,3,-5,4,21,0,0,0,0,1,3,0,0
8477919,Frederick Gaudreau,PIT,C,20,0,3,3,0,2,14,0,0,0,0,8,8,0,0
8478466,Daniel Sprong,WSH,RW,8,2,1,3,2,0,22,1,0,0,0,4,9,0,0
8478104,Sammy Blais,STL,LW,11,1,2,3,1,6,9,0,1,0,1,2,15,0,0
8478846,Christian Wolanin,OTT,D,10,1,2,3,-4,0,14,0,0,0,0,5,5,0,0
8479977,Kailer Yamamoto,EDM,RW,9,0,3,3,-2,2,23,0,0,1,1,3,6,0,0
8476428,Rocco Grimaldi,NSH,RW,6,1,2,3,0,0,7,0,0,0,0,5,3,0,0
8475868,Anthony Bitetto,NYR,D,32,1,2,3,-1,27,25,1,0,0,0,31,40,0,0
8477341,Andreas Johnsson,NJD,LW,9,2,1,3,-2,0,19,0,0,1,1,5,5,0,0
8477998,Warren Foegele,CAR,LW,2,2,1,3,3,0,6,0,0,0,0,1,5,0,0
8474749,Matt Bartkowski,MIN,D,18,0,3,3,-3,4,21,0,0,0,0,13,31,0,0
8477478,William Carrier,VGK,LW,37,1,2,3,-3,19,52,0,0,0,0,10,113,0,0
8478011,Louie Belpedio,MIN,D,1,0,2,2,1,0,0,0,0,0,0,1,1,0,0
8480072,Lias Andersson,LAK,C,7,1,1,2,1,0,5,0,0,0,0,3,9,0,0
8478506,Gabriel Carlsson,CBJ,D,14,0,2,2,0,4,18,0,0,0,0,10,10,0,0
8476407,Andy Welinski,ANA,D,7,0,2,2,-1,0,6,0,0,0,0,8,4,0,0
8477359,Tucker Poolman,WPG,D,24,1,1,2,2,0,27,0,0,0,0,18,20,0,0
8477450,Jason Dickinson,DAL,C,27,0,2,2,-2,17,16,0,0,0,0,5,45,0,0
8475718,Justin Holl,TOR,D,2,2,0,2,5,0,2,1,0,0,0,3,2,0,0
8478146,Matthew Highmore,CHI,C,13,2,0,2,-4,0,27,0,0,0,0,7,9,0,0
8477464,Nic Petan,TOR,C,15,2,0,2,0,6,16,1,0,0,0,4,4,0,0
8476166,Taylor Fedun,DAL,D,7,0,1,1,-1,2,8,0,0,0,0,10,4,0,0
8474567,Zach Bogosian,TOR,D,18,0,1,1,-9,20,29,0,0,0,0,23,22,0,0
8480015,Owen Tippett,FLA,RW,7,1,0,1,-6,0,17,0,0,0,0,4,3,0,0
8479423,Alex Nylander,CHI,LW,3,1,0,1,-3,0,2,0,0,0,0,0,0,0,0
8477426,Nick Paul,OTT,LW,11,1,0,1,-4,0,11,0,0,0,0,4,16,0,0
8476329,Travis Boyd,TOR,C,8,0,1,1,2,2,2,0,0,0,0,1,2,0,0
8476415,Kyle Rau,MIN,C,3,0,1,1,0,0,4,0,0,0,0,0,7,0,0
8478474,Lawson Crouse,ARI,LW,11,1,0,1,-6,7,13,0,0,0,0,6,29,0,0
8476870,Stefan Matteau,CBJ,C,8,0,1,1,0,0,8,0,0,0,0,1,8,0,0
8477520,Jean-Sebastien Dea,BUF,C,5,1,0,1,1,2,1,1,0,0,0,1,9,0,0
8477446,Michael McCarron,NSH,RW,18,0,1,1,-1,32,15,0,0,0,0,14,61,0,0
8478915,Sami Niku,WPG,D,1,1,0,1,0,0,2,0,0,0,0,3,0,0,0
8477433,Ben Harpur,NSH,D,41,0,1,1,-21,21,26,0,0,0,0,35,71,0,0
8478413,Jordan Greenway,MIN,LW,6,0,1,1,0,0,4,0,0,0,0,3,5,0,0
8478027,Lucas Wallmark,CHI,C,11,1,0,1,-4,2,16,0,0,0,0,1,13,0,0
8477962,Brendan Lemieux,NYR,LW,9,1,0,1,2,21,6,0,0,0,0,1,12,0,0
8479066,Ryan Lomberg,FLA,LW,7,0,1,1,0,15,5,0,0,0,0,1,11,0,0
8479511,Janne Kuokkanen,NJD,LW,4,0,0,0,-3,0,6,0,0,0,0,1,1,0,0
8478462,Nicolas Roy,VGK,C,1,0,0,0,-1,0,1,0,0,0,0,0,2,0,0
8479580,Dylan Gambrell,SJS,C,3,0,0,0,-1,0,1,0,0,0,0,2,0,0,0
8479291,Kevin Rooney,NYR,C,1,0,0,0,0,0,3,0,0,0,0,0,2,0,0
8477369,Carson Soucy,MIN,D,3,0,0,0,-2,2,4,0,0,0,0,3,4,0,0
8477541,Dakota Mermis,MIN,D,9,0,0,0,-2,0,7,0,0,0,0,6,5,0,0
8477936,Michael Dal Colle,NYI,LW,4,0,0,0,0,0,1,0,0,0,0,1,1,0,0
8476807,Matt Tennyson,NJD,D,15,0,0,0,-8,8,25,0,0,0,0,11,13,0,0
8478476,Kyle Capobianco,ARI,D,1,0,0,0,-1,0,0,0,0,0,0,1,3,0,0
8480762,Eric Robinson,CBJ,LW,1,0,0,0,1,0,2,0,0,0,0,0,0,0,0
8480039,Martin Necas,CAR,C,1,0,0,0,0,0,0,0,0,0,0,0,0,0,0
8478233,Andrew Mangiapane,CGY,LW,10,0,0,0,-3,2,7,0,0,0,0,4,9,0,0
8478397,Rasmus Andersson,CGY,D,10,0,0,0,-1,4,8,0,0,0,0,10,2,0,0
8478447,Nicholas Merkley,NJD,RW,1,0,0,0,0,2,0,0,0,0,0,0,0,0,0
8480009,Eeli Tolvanen,NSH,RW,3,0,0,0,0,0,3,0,0,0,0,1,2,0,0
8478873,Troy Terry,ANA,RW,2,0,0,0,0,0,3,0,0,0,0,2,0,0,0
8477810,Joel Hanley,DAL,D,5,0,0,0,0,0,2,0,0,0,0,4,1,0,0
8478874,Adam Gaudette,VAN,C,5,0,0,0,2,0,9,0,0,0,0,3,2,0,0
8480727,Zach Whitecloud,VGK,D,1,0,0,0,3,0,0,0,0,0,0,1,0,0,0
