Player Name,Team,Position,Games,G,A,Points,+/-,PIM,SOG,GWG,PPG,PPA,PPP,BS,Hits,SHG,SHA
Leon Draisaitl,EDM,C,71,43,67,110,-7,18,218,10,16,28,44,19,27,0,0
Connor McDavid,EDM,C,64,34,63,97,-6,28,212,6,11,32,43,18,37,0,0
Artemi Panarin,NYR,LW,69,32,63,95,36,20,209,4,7,17,24,18,25,0,0
David Pastrnak,BOS,RW,70,48,47,95,21,40,279,10,20,18,38,22,47,0,0
Nathan MacKinnon,COL,C,69,35,58,93,13,12,318,4,12,19,31,31,51,0,0
Brad Marchand,BOS,LW,70,28,59,87,25,82,185,5,5,23,28,19,55,1,2
Patrick Kane,CHI,RW,70,33,51,84,8,40,275,2,8,15,23,19,24,0,0
Auston Matthews,TOR,C,70,47,33,80,19,8,290,5,12,13,25,60,40,0,0
Jonathan Huberdeau,FLA,LW,69,23,55,78,5,30,152,3,5,24,29,26,51,0,0
Jack Eichel,BUF,C,68,36,42,78,5,34,227,9,11,16,27,42,40,1,0
John Carlson,WSH,D,69,15,60,75,12,26,189,6,2,24,26,108,55,0,0
Mika Zibanejad,NYR,C,57,41,34,75,9,14,208,6,15,12,27,49,51,3,2
Evgeni Malkin,PIT,C,55,25,49,74,7,58,171,5,7,17,24,22,38,0,0
Kyle Connor,WPG,LW,71,38,35,73,4,34,239,7,9,8,17,17,18,1,1
Mark Scheifele,WPG,C,71,29,44,73,2,45,170,6,10,10,20,49,34,0,0
J.T. Miller,VAN,C,69,27,45,72,11,47,165,3,9,16,25,38,123,0,2
Mitchell Marner,TOR,RW,59,16,51,67,6,16,154,2,6,18,24,37,24,0,1
Alex Ovechkin,WSH,LW,68,48,19,67,-12,30,311,3,13,5,18,30,184,0,0
Sebastian Aho,CAR,C,68,38,28,66,10,26,206,5,8,9,17,20,55,4,1
Max Pacioretty,VGK,LW,71,32,34,66,18,44,307,5,8,11,19,35,90,0,0
Steven Stamkos,TBL,C,57,29,37,66,14,22,176,6,10,9,19,38,69,0,0
Elias Pettersson,VAN,C,68,27,39,66,16,18,162,5,8,16,24,42,63,0,0
Roman Josi,NSH,D,69,16,49,65,22,41,260,1,4,19,23,108,52,0,0
Blake Wheeler,WPG,RW,71,22,43,65,1,37,180,2,4,18,22,51,102,1,1
Brayden Point,TBL,C,66,25,39,64,28,11,141,4,8,5,13,30,24,0,0
Mark Stone,VGK,RW,65,21,42,63,15,27,168,3,6,11,17,51,56,0,1
Teuvo Teravainen,CAR,LW,68,15,48,63,20,8,182,1,4,17,21,30,18,1,3
Patrik Laine,CBJ,RW,68,28,35,63,8,22,226,1,8,8,16,35,97,0,0
Aleksander Barkov,FLA,C,66,20,42,62,2,18,172,2,7,13,20,35,21,0,1
Anze Kopitar,LAK,C,70,21,41,62,6,16,135,5,7,14,21,56,49,1,0
Travis Konecny,PHI,RW,66,24,37,61,-1,28,141,3,5,18,23,30,63,0,0
Ryan Nugent-Hopkins,EDM,C,65,22,39,61,1,33,172,4,7,17,24,44,33,0,0
Matthew Tkachuk,CGY,LW,69,23,38,61,-5,74,188,4,5,14,19,22,122,0,0
Andrei Svechnikov,CAR,RW,68,24,37,61,9,54,183,5,6,14,20,27,116,0,0
Tomas Tatar,MTL,LW,68,22,39,61,5,36,162,1,8,6,14,24,79,0,0
Ryan O'Reilly,STL,C,71,12,49,61,11,10,118,3,2,16,18,42,16,1,0
Mathew Barzal,NYI,C,68,19,41,60,5,44,171,2,4,8,12,43,22,0,0
Jonathan Toews,CHI,C,70,18,42,60,-2,48,172,3,1,7,8,35,56,1,0
John Tavares,TOR,C,63,26,34,60,-7,24,197,4,7,14,21,31,32,0,0
David Perron,STL,LW,71,25,35,60,2,52,166,9,9,18,27,19,67,0,0
Sean Couturier,PHI,C,69,22,37,59,21,30,185,4,4,9,13,26,60,0,0
Ryan Strome,NYR,C,70,18,41,59,21,48,154,3,3,14,17,32,45,0,1
Mike Hoffman,STL,C,69,29,30,59,-5,28,214,3,11,10,21,22,33,0,0
William Nylander,TOR,RW,68,31,28,59,-2,12,197,7,9,8,17,14,9,0,0
Nikolaj Ehlers,WPG,LW,71,25,33,58,14,30,203,5,3,2,5,28,36,1,0
Johnny Gaudreau,CGY,LW,70,18,40,58,-10,12,209,2,6,12,18,11,1,0,0
Brayden Schenn,STL,C,71,25,33,58,3,44,138,4,10,11,21,21,119,0,0
Jaden Schwartz,STL,LW,71,22,35,57,3,18,162,4,9,11,20,28,60,0,0
Jakub Voracek,PHI,RW,69,12,44,56,14,31,132,3,4,13,17,21,17,0,0
Patrice Bergeron,BOS,C,61,31,25,56,23,28,203,5,11,9,20,46,46,1,0
Bryan Rust,PIT,RW,55,27,29,56,14,30,151,4,8,9,17,35,71,1,1
Victor Hedman,TBL,D,66,11,44,55,27,31,155,3,4,18,22,98,73,0,0
Elias Lindholm,CGY,C,70,29,25,54,-8,22,169,7,8,11,19,41,93,0,0
Kevin Fiala,MIN,LW,64,23,31,54,-1,42,175,4,9,9,18,18,25,0,0
Brock Nelson,NYI,C,68,26,28,54,6,32,175,5,4,3,7,44,49,0,0
Reilly Smith,VGK,RW,71,27,27,54,17,20,169,6,3,2,5,30,55,2,2
Nicklas Backstrom,WSH,C,61,12,42,54,-1,14,132,0,2,16,18,45,30,0,0
Quinn Hughes,VAN,D,68,8,45,53,-10,22,126,2,3,22,25,46,7,0,0
Bo Horvat,VAN,C,69,22,31,53,-15,21,178,2,12,4,16,66,55,0,0
Claude Giroux,PHI,C,69,21,32,53,7,28,197,6,7,13,20,16,45,1,1
Dylan Larkin,DET,C,71,19,34,53,-21,39,223,0,5,9,14,45,52,0,0
Taylor Hall,BUF,LW,65,16,36,52,-14,34,232,1,4,14,18,29,47,0,0
Evgeny Kuznetsov,WSH,C,63,19,33,52,-2,40,129,0,6,6,12,16,35,0,0
Jakub Vrana,WSH,LW,69,25,27,52,3,18,187,6,1,11,12,16,29,0,0
Alex Pietrangelo,VGK,D,70,16,36,52,11,20,225,3,6,16,22,89,47,0,1
Tyler Seguin,DAL,C,69,17,33,50,-2,22,245,6,3,12,15,31,90,0,0
Sam Reinhart,BUF,RW,69,22,28,50,-15,20,144,2,5,7,12,27,36,0,0
Cale Makar,COL,D,57,12,38,50,12,12,121,4,4,15,19,47,45,0,0
T.J. Oshie,WSH,RW,69,26,23,49,4,26,133,4,10,2,12,58,90,0,0
Alex Killorn,TBL,LW,68,26,23,49,19,20,130,7,8,5,13,15,59,0,0
Pierre-Luc Dubois,WPG,LW,70,18,31,49,-2,49,158,4,1,9,10,50,85,0,0
Torey Krug,STL,D,61,9,40,49,-4,33,144,4,2,26,28,48,36,0,0
Timo Meier,SJS,RW,70,22,27,49,-22,42,199,2,2,7,9,38,155,0,0
Tyler Bertuzzi,DET,LW,71,21,27,48,-23,40,129,1,3,11,14,30,71,0,0
Sean Monahan,CGY,C,70,22,26,48,-16,25,166,5,8,8,16,22,65,0,0
Filip Forsberg,NSH,LW,63,21,27,48,-7,29,198,2,7,7,14,27,82,0,0
Ryan Suter,MIN,D,69,8,40,48,-6,12,111,2,2,16,18,93,48,0,0
Sidney Crosby,PIT,C,41,16,31,47,-8,15,109,4,4,13,17,17,28,0,0
Eric Staal,BUF,C,66,19,28,47,-9,28,113,5,5,9,14,22,24,0,0
Evander Kane,SJS,LW,64,26,21,47,-12,122,216,6,14,4,18,25,135,2,0
Evgenii Dadonov,OTT,RW,69,25,22,47,-7,10,167,2,11,6,17,24,29,0,0
Phillip Danault,MTL,C,71,13,34,47,18,32,131,1,1,3,4,37,119,0,0
Jonathan Marchessault,VGK,C,66,22,25,47,6,28,235,3,6,6,12,12,99,0,0
William Karlsson,VGK,C,63,15,31,46,11,16,138,1,2,6,8,38,40,2,3
Shea Theodore,VGK,D,71,13,33,46,12,25,219,4,1,15,16,69,20,1,0
Pavel Buchnevich,NYR,RW,68,16,30,46,2,24,148,1,4,5,9,22,80,0,0
Zach Parise,MIN,LW,69,25,21,46,-11,8,155,4,12,6,18,38,27,1,0
Dominik Kubalik,CHI,LW,68,30,16,46,2,16,157,3,4,4,8,17,79,0,0
Brock Boeser,VAN,RW,57,16,29,45,4,14,169,3,5,9,14,14,28,0,0
Tanner Pearson,VAN,LW,69,21,24,45,-4,27,164,3,3,7,10,40,96,2,1
Alex DeBrincat,CHI,LW,70,18,27,45,-10,15,207,4,10,6,16,19,58,0,0
Kyle Palmieri,NJD,RW,65,25,20,45,-4,41,155,3,11,7,18,36,74,0,0
Mikael Backlund,CGY,C,70,16,29,45,3,26,157,3,3,7,10,11,44,3,0
Neal Pionk,WPG,D,71,6,39,45,10,32,177,1,3,22,25,78,165,0,0
Nick Schmaltz,ARI,C,70,11,34,45,3,20,95,2,2,11,13,34,12,0,0
Keith Yandle,FLA,D,69,5,40,45,0,20,129,0,2,19,21,51,18,0,0
Chris Kreider,NYR,LW,63,24,21,45,13,58,156,5,9,4,13,42,116,0,0
Andre Burakovsky,COL,LW,58,20,25,45,11,22,103,6,2,9,11,34,26,0,0
Brent Burns,SJS,D,70,12,33,45,-22,34,225,1,5,12,17,115,72,0,1
Kris Letang,PIT,D,61,15,29,44,0,38,177,2,6,9,15,91,101,0,0
Gabriel Landeskog,COL,LW,54,21,23,44,-2,47,145,4,6,9,15,35,86,0,0
Anthony Cirelli,TBL,C,68,16,28,44,28,30,113,3,1,4,5,47,89,1,1
Max Domi,CBJ,C,71,17,27,44,-3,35,179,3,1,10,11,13,32,0,0
Tom Wilson,WSH,RW,68,21,23,44,-3,93,154,5,5,2,7,58,253,1,1
Nikita Gusev,NJD,LW,66,13,31,44,-15,12,158,2,5,10,15,7,12,0,0
Clayton Keller,ARI,RW,70,17,27,44,-6,28,184,2,2,13,15,13,20,0,0
Brady Tkachuk,OTT,LW,71,21,23,44,-14,106,259,3,2,6,8,43,303,0,0
Tyler Toffoli,MTL,C,68,24,20,44,-1,20,203,4,5,5,10,16,48,0,0
David Krejci,BOS,C,61,13,30,43,14,23,83,3,3,11,14,32,37,0,0
Anders Lee,NYI,LW,68,20,23,43,8,47,195,6,2,5,7,50,102,0,0
Brendan Gallagher,MTL,RW,59,22,21,43,9,29,226,1,1,4,5,29,53,0,0
Alex Iafallo,LAK,LW,70,17,26,43,1,14,142,3,6,3,9,47,49,0,0
Josh Bailey,NYI,RW,68,14,29,43,-12,10,94,2,2,7,9,48,20,1,0
Connor Brown,OTT,RW,71,16,27,43,-6,24,173,1,3,1,4,35,39,0,2
Jake Guentzel,PIT,LW,39,20,23,43,11,14,127,4,6,4,10,19,46,0,0
Adam Henrique,ANA,C,71,26,17,43,-2,22,169,1,5,4,9,32,75,0,0
Rickard Rakell,ANA,LW,65,15,27,42,-5,12,186,2,3,6,9,29,81,0,3
Robert Thomas,STL,C,66,10,32,42,9,18,87,2,1,6,7,13,13,0,0
Victor Olofsson,BUF,LW,54,20,22,42,-1,6,127,4,11,6,17,16,10,0,0
Matt Duchene,NSH,C,66,13,29,42,-4,24,136,1,5,6,11,22,40,0,0
Jean-Gabriel Pageau,NYI,C,67,26,16,42,4,49,151,5,5,5,10,53,128,3,3
Ryan Getzlaf,ANA,C,69,13,29,42,-16,58,143,5,3,6,9,69,125,0,0
Adam Fox,NYR,D,70,8,34,42,22,32,125,4,1,12,13,92,35,0,0
Zach Werenski,CBJ,D,63,20,21,41,9,10,187,4,5,8,13,58,36,1,0
Mikko Rantanen,COL,RW,42,19,22,41,-2,14,107,5,8,6,14,23,28,0,0
Ondrej Palat,TBL,LW,69,17,24,41,25,22,128,2,4,4,8,61,145,1,0
Jason Zucker,PIT,LW,60,20,21,41,-4,21,111,4,7,5,12,23,53,0,0
Kevin Hayes,PHI,C,69,23,18,41,-6,34,175,5,4,3,7,22,88,4,0
Aaron Ekblad,FLA,D,67,5,36,41,12,26,147,1,0,6,6,84,34,0,1
Nick Suzuki,MTL,C,71,13,28,41,-15,6,138,1,6,8,14,32,64,0,0
Jordan Eberle,NYI,RW,58,16,24,40,1,12,136,1,4,7,11,39,37,0,0
Dougie Hamilton,CAR,D,47,14,26,40,30,32,170,3,2,10,12,63,52,0,1
Rasmus Dahlin,BUF,D,59,4,36,40,-7,38,90,1,2,17,19,51,72,0,0
James van Riemsdyk,PHI,LW,66,19,21,40,5,8,151,2,4,5,9,18,25,0,0
Erik Karlsson,SJS,D,56,6,34,40,-15,16,120,0,1,12,13,74,26,1,0
Anthony Duclair,FLA,LW,66,23,17,40,-5,18,184,2,5,3,8,39,53,2,0
Jeff Petry,MTL,D,71,11,29,40,-10,26,158,3,3,9,12,79,177,1,0
Conor Garland,ARI,RW,68,22,17,39,1,20,158,5,4,6,10,20,26,0,0
Jamie Benn,DAL,LW,69,19,20,39,-4,53,163,4,8,6,14,57,167,0,0
Tyson Barrie,EDM,D,70,5,34,39,-7,16,169,0,1,11,12,76,47,0,0
Anthony Beauvillier,NYI,LW,68,18,21,39,-11,15,132,3,3,4,7,36,86,1,0
Logan Couture,SJS,C,52,16,23,39,0,18,126,3,0,9,9,45,54,0,2
Jakob Silfverberg,ANA,RW,66,21,18,39,0,14,155,1,4,3,7,41,28,2,0
Lars Eller,WSH,C,69,16,23,39,3,48,151,1,2,4,6,44,59,1,1
Thomas Chabot,OTT,D,71,6,33,39,-18,42,186,0,0,11,11,85,79,0,0
Paul Stastny,WPG,C,71,17,21,38,6,24,136,3,5,5,10,32,63,0,1
Christian Dvorak,ARI,C,70,18,20,38,6,12,134,2,6,4,10,36,39,0,0
Phil Kessel,ARI,RW,70,14,24,38,-21,22,153,2,9,8,17,20,11,0,0
Vincent Trocheck,CAR,C,62,11,27,38,-8,49,141,2,1,6,7,37,101,1,0
Anthony Mantha,DET,RW,43,16,22,38,-7,34,137,3,6,3,9,25,49,0,0
Dylan Strome,CHI,C,58,12,26,38,1,16,97,2,2,6,8,29,23,0,0
Ryan Ellis,NSH,D,49,8,30,38,16,19,114,3,2,7,9,96,48,0,0
Charlie Coyle,BOS,C,70,16,21,37,9,21,145,3,1,4,5,34,83,2,0
Zach Hyman,TOR,LW,51,21,16,37,13,23,106,1,3,3,6,23,52,1,0
Tyler Ennis,EDM,C,70,16,21,37,-6,20,159,1,5,5,10,26,96,0,0
Chris Tierney,OTT,C,71,11,26,37,-6,20,102,2,1,1,2,37,44,4,1
Mats Zuccarello,MIN,RW,65,15,22,37,-9,18,96,2,3,4,7,36,13,0,0
Nazem Kadri,COL,C,51,19,17,36,7,97,133,1,4,7,11,9,61,0,0
Tomas Hertl,SJS,C,48,16,20,36,-18,16,117,1,2,5,7,25,29,2,0
Kasperi Kapanen,PIT,RW,69,13,23,36,0,22,121,2,0,3,3,17,73,2,0
Jaccob Slavin,CAR,D,68,6,30,36,30,10,145,3,0,3,3,107,43,0,1
Martin Necas,CAR,C,64,16,20,36,-6,20,88,3,5,4,9,19,65,0,0
Ryan Johansen,NSH,C,68,14,22,36,-5,45,101,2,3,6,9,34,39,1,0
Oliver Bjorkstrand,CBJ,RW,49,21,15,36,8,12,162,5,3,3,6,16,43,0,0
Shea Weber,MTL,D,65,15,21,36,8,33,185,2,3,5,8,114,112,0,0
Ivan Provorov,PHI,D,69,13,23,36,11,24,150,3,7,9,16,111,84,0,1
Jake Virtanen,VAN,RW,69,18,18,36,-4,41,150,6,6,3,9,28,102,0,0
Jared McCann,PIT,C,66,14,21,35,6,17,150,4,2,4,6,27,89,0,0
Carl Soderberg,CHI,C,70,17,18,35,6,18,135,1,6,5,11,41,77,0,0
Jake DeBrusk,BOS,LW,65,19,16,35,-1,14,161,5,7,3,10,15,35,0,0
Miro Heiskanen,DAL,D,68,8,27,35,14,12,163,0,0,7,7,84,40,0,0
Dustin Brown,LAK,RW,66,17,18,35,-1,22,169,1,1,4,5,15,143,0,0
Nick Bonino,MIN,C,67,18,17,35,17,16,104,3,1,0,1,89,17,0,0
Ryan Pulock,NYI,D,68,10,25,35,8,14,163,3,3,5,8,139,110,0,0
Drew Doughty,LAK,D,67,7,28,35,-16,36,141,2,5,9,14,87,106,0,1
Samuel Girard,COL,D,70,4,30,34,1,17,96,1,1,12,13,92,46,0,0
Frank Vatrano,FLA,C,69,16,18,34,-8,30,162,4,2,0,2,43,102,2,0
Calle Jarnkrok,NSH,C,64,15,19,34,4,14,136,1,2,7,9,27,28,2,0
Zack Kassian,EDM,RW,59,15,19,34,0,69,99,1,0,0,0,8,157,0,0
Kevin Shattenkirk,ANA,D,70,8,26,34,22,38,131,0,1,6,7,66,62,0,0
Mikhail Sergachev,TBL,D,70,10,24,34,15,58,118,0,5,8,13,99,106,1,0
Alexander Radulov,DAL,RW,60,15,19,34,8,46,132,3,7,3,10,42,48,0,0
Alexander Edler,VAN,D,59,5,28,33,13,62,118,1,1,6,7,162,108,0,0
Adam Gaudette,VAN,C,59,12,21,33,-7,37,75,1,4,8,12,20,29,0,0
Darnell Nurse,EDM,D,71,5,28,33,-2,48,170,1,0,5,5,141,172,0,0
Kevin Labanc,SJS,RW,70,14,19,33,-33,38,176,3,3,6,9,24,46,0,0
Rasmus Ristolainen,BUF,D,69,6,27,33,-2,46,128,0,2,7,9,82,203,0,1
Roope Hintz,DAL,LW,60,19,14,33,3,16,120,5,3,11,14,28,73,2,0
Mattias Ekholm,NSH,D,68,8,25,33,-1,32,154,2,0,5,5,100,49,1,1
Brett Connolly,FLA,RW,69,19,14,33,-3,26,117,3,4,2,6,17,56,0,0
Joonas Donskoi,COL,RW,65,16,17,33,2,26,111,2,4,1,5,38,25,0,0
Brandon Saad,COL,LW,58,21,12,33,2,16,140,5,1,0,1,19,36,2,0
Pavel Zacha,NJD,C,65,8,24,32,-12,14,97,1,3,5,8,19,62,2,2
Charlie McAvoy,BOS,D,67,5,27,32,24,41,101,1,1,1,2,131,131,0,1
Jesper Bratt,NJD,LW,60,16,16,32,-6,6,101,2,1,5,6,22,29,0,0
Blake Coleman,TBL,C,66,21,11,32,0,56,200,2,1,2,3,46,191,3,1
Robby Fabbri,DET,C,61,15,17,32,-33,20,111,3,6,3,9,14,75,0,0
Derick Brassard,ARI,C,66,10,22,32,-2,16,110,1,3,7,10,24,115,0,0
Alex Goligoski,ARI,D,70,4,28,32,8,24,101,0,2,9,11,134,91,0,0
John Klingberg,DAL,D,58,6,26,32,-10,22,120,0,2,15,17,72,29,0,0
Patric Hornqvist,FLA,RW,52,17,15,32,9,36,168,2,3,4,7,41,107,0,0
Jared Spurgeon,MIN,D,62,12,20,32,-1,18,112,2,3,10,13,102,61,0,0
Adrian Kempe,LAK,C,69,11,21,32,-10,29,148,2,2,8,10,17,71,2,2
Andrew Mangiapane,CGY,LW,68,17,15,32,4,18,109,2,0,1,1,25,73,0,0
Rocco Grimaldi,NSH,RW,66,10,21,31,10,10,122,1,0,0,0,14,23,0,0
Josh Morrissey,WPG,D,65,5,26,31,1,24,120,0,1,11,12,59,34,0,0
Kyle Turris,EDM,C,62,9,22,31,-9,22,88,4,2,8,10,25,18,0,0
Nick Foligno,CBJ,LW,67,10,21,31,-3,62,131,1,2,2,4,50,212,0,1
Joe Pavelski,DAL,C,67,14,17,31,6,29,125,3,6,5,11,52,62,0,1
Luke Kunin,NSH,C,63,15,16,31,-10,55,128,1,0,2,2,54,64,1,0
Nate Schmidt,VAN,D,59,7,24,31,11,12,112,0,1,6,7,91,25,0,0
Craig Smith,BOS,C,69,18,13,31,18,34,184,2,4,3,7,19,60,0,0
Dominik Kahun,EDM,C,56,12,19,31,8,8,87,2,1,1,2,22,5,0,0
J.T. Compher,COL,LW,67,11,20,31,9,18,106,3,1,4,5,60,36,0,3
Tyler Johnson,TBL,C,65,14,17,31,9,16,113,2,1,6,7,22,62,0,0
Filip Hronek,DET,D,65,9,22,31,-38,46,125,0,1,9,10,74,105,0,0
Vladislav Namestnikov,DET,C,65,17,14,31,-5,45,98,2,2,2,4,47,108,4,2
James Neal,EDM,LW,55,19,12,31,-20,12,112,2,12,5,17,17,88,0,0
Joe Thornton,TOR,C,70,7,24,31,-19,34,76,1,3,5,8,29,20,0,0
Damon Severson,NJD,D,69,8,23,31,-20,52,114,2,3,7,10,97,81,0,0
Mark Giordano,CGY,D,60,5,26,31,2,34,157,0,2,9,11,148,42,0,2
Zach Sanford,STL,LW,58,16,14,30,13,28,90,3,1,0,1,32,109,0,0
Marcus Johansson,MIN,C,60,9,21,30,-12,20,87,1,1,5,6,22,39,0,0
Seth Jones,CBJ,D,56,6,24,30,10,20,126,0,2,7,9,123,62,0,1
Warren Foegele,CAR,LW,68,13,17,30,9,34,129,1,0,0,0,17,64,3,0
Mikael Granlund,NSH,C,63,17,13,30,-4,28,130,4,4,2,6,55,42,1,0
Joel Armia,MTL,RW,58,16,14,30,2,28,155,2,3,1,4,25,146,3,1
Yanni Gourde,TBL,C,70,10,20,30,-5,49,110,5,1,5,6,20,78,2,1
Oliver Ekman-Larsson,ARI,D,66,9,21,30,-3,38,135,1,2,5,7,65,129,1,0
Jack Roslovic,CBJ,C,71,12,17,29,4,12,117,0,1,1,2,21,58,0,0
Denis Gurianov,DAL,RW,64,20,9,29,5,13,132,4,7,5,12,18,63,0,0
Jesper Fast,CAR,RW,69,12,17,29,16,20,84,1,0,0,0,53,125,2,0
Derek Ryan,CGY,C,68,10,19,29,9,10,102,0,1,3,4,34,12,1,1
Nino Niederreiter,CAR,RW,67,11,18,29,-3,42,115,2,4,7,11,19,52,0,0
Tyler Bozak,STL,C,67,13,16,29,0,10,109,2,2,2,4,33,32,1,0
Cam Fowler,ANA,D,59,9,20,29,0,20,117,2,2,6,8,58,25,0,0
Erik Gustafsson,PHI,D,66,6,23,29,-9,27,103,0,2,7,9,58,86,0,0
Joel Eriksson Ek,MIN,C,62,8,21,29,7,22,102,4,1,0,1,43,93,0,1
Viktor Arvidsson,NSH,RW,57,15,13,28,-4,26,127,1,4,4,8,24,27,0,0
Devon Toews,COL,D,68,6,22,28,1,16,122,1,1,5,6,75,55,0,0
Colton Parayko,STL,D,64,10,18,28,8,16,162,1,3,2,5,106,87,0,1
Jordan Greenway,MIN,LW,67,8,20,28,2,54,93,1,0,3,3,44,95,0,0
Derek Stepan,OTT,C,70,10,18,28,-4,16,158,2,1,6,7,54,43,1,0
Alexander Kerfoot,TOR,C,65,9,19,28,-2,32,88,1,1,2,3,41,48,0,0
Artturi Lehkonen,MTL,LW,70,13,14,27,2,24,140,1,0,0,0,38,120,1,0
Scott Laughton,PHI,C,49,13,14,27,13,26,74,2,0,0,0,26,109,0,0
Jacob Trouba,NYR,D,70,7,20,27,-12,61,168,1,4,4,8,128,173,0,2
Dmitry Orlov,WSH,D,69,4,23,27,5,36,105,2,1,4,5,82,106,0,1
Jeff Carter,LAK,C,60,17,10,27,-21,36,182,7,3,2,5,23,66,0,0
Jordan Staal,CAR,C,68,8,19,27,3,40,125,0,2,1,3,36,149,0,0
Duncan Keith,CHI,D,61,3,24,27,1,18,111,0,2,9,11,117,26,0,0
Morgan Rielly,TOR,D,47,3,24,27,6,24,123,2,0,7,7,67,38,0,0
Noel Acciari,FLA,C,66,20,7,27,2,21,108,5,0,0,0,103,121,1,0
Valeri Nichushkin,COL,RW,65,13,14,27,26,14,113,3,1,0,1,22,84,1,0
Jakob Chychrun,ARI,D,63,12,14,26,4,38,149,2,5,3,8,95,75,0,0
Barclay Goodrow,TBL,C,70,8,18,26,-8,97,102,2,0,2,2,66,162,0,1
Andrew Copp,WPG,C,63,10,16,26,-3,10,121,5,1,0,1,27,59,0,3
Kailer Yamamoto,EDM,RW,27,11,15,26,17,12,44,0,2,0,2,13,45,0,0
Alex Nylander,CHI,LW,65,10,16,26,-2,10,94,1,0,2,2,14,29,0,0
Ivan Barbashev,STL,C,69,11,15,26,4,23,75,2,0,0,0,33,144,2,1
Chandler Stephenson,VGK,C,65,11,15,26,24,16,73,5,1,1,2,32,52,2,1
Andreas Athanasiou,LAK,C,55,11,15,26,-46,30,129,2,3,4,7,24,36,0,0
Danton Heinen,ANA,LW,67,10,16,26,-2,10,109,2,3,3,6,34,35,0,0
John Marino,PIT,D,56,6,20,26,17,20,61,0,1,3,4,77,72,0,0
Ryan Graves,COL,D,69,9,17,26,40,45,134,0,0,0,0,150,112,0,2
Ian Cole,MIN,D,65,4,22,26,21,36,92,1,0,0,0,122,83,0,0
Cam Atkinson,CBJ,RW,44,12,14,26,2,6,148,2,3,5,8,21,18,0,0
Marcus Foligno,MIN,LW,59,11,14,25,8,30,86,0,0,0,0,36,184,0,0
Brandon Tanev,PIT,LW,68,11,14,25,-1,16,95,4,0,1,1,65,244,2,1
Lucas Wallmark,CHI,C,67,12,13,25,0,18,84,0,3,3,6,26,57,0,1
Travis Sanheim,PHI,D,69,8,17,25,4,32,110,0,0,4,4,79,41,0,0
Derek Grant,ANA,C,56,15,10,25,1,30,94,5,2,0,2,25,54,3,2
Lawson Crouse,ARI,LW,66,15,10,25,0,33,109,3,0,0,0,29,201,1,0
Jason Spezza,TOR,C,58,9,16,25,-3,18,73,0,2,5,7,19,13,0,0
Wayne Simmonds,TOR,RW,68,8,17,25,-21,66,119,1,5,4,9,29,145,0,0
Carl Hagelin,WSH,LW,58,8,17,25,12,16,107,2,0,0,0,19,24,1,2
Matt Calvert,COL,LW,50,12,13,25,13,39,89,1,0,0,0,22,58,3,1
Nick Cousins,NSH,C,65,10,15,25,0,35,115,0,3,2,5,31,91,0,0
Sean Walker,LAK,D,70,5,19,24,-12,26,127,0,0,5,5,84,81,0,0
Jake Gardiner,CAR,D,68,4,20,24,-24,30,87,2,1,10,11,42,43,0,0
Boone Jenner,CBJ,C,70,11,13,24,-14,36,179,1,2,2,4,80,109,0,1
Matt Dumba,MIN,D,69,6,18,24,-7,41,167,1,1,7,8,88,98,0,1
Erik Haula,NSH,LW,48,12,12,24,1,22,92,2,4,4,8,15,27,0,0
Brady Skjei,CAR,D,67,8,16,24,-10,45,139,1,0,0,0,96,103,0,2
Alex Chiasson,EDM,RW,65,11,13,24,-3,42,97,3,6,7,13,15,56,0,0
Ondrej Kase,BOS,RW,55,7,17,24,-7,14,144,0,0,2,2,17,13,1,0
Conor Sheary,WSH,LW,63,10,13,23,-5,10,102,1,1,2,3,26,28,0,0
Kirby Dach,CHI,C,64,8,15,23,-1,24,101,2,0,3,3,23,33,0,0
Sonny Milano,ANA,LW,55,7,16,23,-7,26,75,2,1,2,3,13,26,0,0
Ryan Donato,SJS,C,62,14,9,23,5,12,95,1,0,2,2,14,53,0,0
Esa Lindell,DAL,D,69,3,20,23,5,12,98,2,1,6,7,127,89,0,3
Oskar Sundqvist,STL,C,57,12,11,23,5,28,97,1,0,0,0,26,60,1,1
Vince Dunn,STL,D,71,9,14,23,15,27,138,1,4,6,10,47,50,0,0
Tyson Jost,COL,C,67,8,15,23,11,22,115,0,1,4,5,18,58,0,0
Blake Lizotte,LAK,C,65,6,17,23,-4,20,87,0,2,1,3,22,42,2,1
Hampus Lindholm,ANA,D,55,2,21,23,-10,34,109,1,1,7,8,71,34,0,2
Sami Vatanen,NJD,D,47,5,18,23,-12,22,95,0,1,9,10,80,50,0,1
Sean Kuraly,BOS,C,69,6,17,23,-2,34,95,0,0,1,1,31,145,0,1
Jeff Skinner,BUF,LW,59,14,9,23,-22,18,183,1,0,3,3,11,29,0,0
Jake Muzzin,TOR,D,53,6,17,23,12,40,99,1,0,0,0,110,109,0,1
Filip Chytil,NYR,C,60,14,9,23,-7,10,114,2,1,2,3,31,13,0,0
Miles Wood,NJD,LW,68,11,12,23,-19,57,141,1,0,0,0,26,102,0,0
Pat Maroon,TBL,LW,64,9,14,23,4,71,80,1,1,2,3,13,104,0,0
Ilya Mikheyev,TOR,RW,39,8,15,23,7,4,98,1,0,0,0,13,26,1,0
Colin White,OTT,C,61,7,16,23,-12,39,83,0,1,3,4,30,47,0,0
Marcus Pettersson,PIT,D,69,2,20,22,9,35,79,0,0,2,2,84,106,0,0
Dominik Simon,CGY,C,64,7,15,22,-9,12,102,0,0,1,1,20,57,0,0
Sam Steel,ANA,C,65,6,16,22,-13,20,85,1,1,7,8,25,24,0,0
Alex Wennberg,FLA,C,57,5,17,22,-5,16,72,1,1,4,5,31,21,0,0
Noah Hanifin,CGY,D,70,5,17,22,-12,12,132,0,1,4,5,89,82,0,0
Rasmus Andersson,CGY,D,70,5,17,22,-7,57,124,0,0,4,4,83,51,0,0
Richard Panik,WSH,RW,59,9,13,22,16,36,67,1,0,0,0,19,75,0,0
Teddy Blueger,PIT,C,69,9,13,22,2,25,102,2,0,0,0,35,83,0,2
Pierre-Edouard Bellemare,COL,C,69,9,13,22,2,17,85,0,0,0,0,46,43,2,2
Patrick Marleau,SJS,C,66,11,11,22,-5,14,117,3,1,0,1,24,57,0,0
Vinnie Hinostroza,FLA,C,68,5,17,22,1,14,132,0,0,1,1,26,51,0,1
Will Butcher,NJD,D,56,4,17,21,-8,6,62,1,0,1,1,75,31,0,0
Andreas Johnsson,NJD,LW,43,8,13,21,0,14,78,1,4,1,5,21,43,0,0
Matt Nieto,SJS,LW,70,8,13,21,7,6,85,3,0,0,0,23,37,2,0
Valtteri Filppula,DET,C,70,6,15,21,-42,24,63,0,1,4,5,31,28,1,0
Mattias Janmark,CHI,C,62,6,15,21,-5,12,86,0,1,4,5,37,22,1,1
Jason Dickinson,DAL,C,65,9,12,21,7,6,85,1,0,0,0,55,89,0,1
Joel Farabee,PHI,LW,52,8,13,21,6,39,81,1,1,1,2,18,31,0,0
Matt Grzelcyk,BOS,D,68,4,17,21,15,34,112,1,1,6,7,67,56,0,1
Corey Perry,MTL,RW,57,5,16,21,-2,70,77,0,1,6,7,33,60,0,0
Nick Ritchie,BOS,LW,48,9,12,21,1,97,78,2,2,1,3,17,102,0,0
Josh Archibald,EDM,RW,62,12,9,21,-8,12,64,3,0,0,0,44,165,2,1
Nick Leddy,NYI,D,60,3,18,21,-1,14,72,0,1,3,4,72,62,0,0
Tyler Myers,VAN,D,68,6,15,21,-7,49,134,1,1,6,7,108,99,1,0
Jack Hughes,NJD,C,61,7,14,21,-26,10,123,2,4,5,9,21,12,0,0
Ben Chiarot,MTL,D,69,9,12,21,5,61,130,3,0,0,0,128,152,0,0
Ethan Bear,EDM,D,71,5,16,21,-4,33,99,1,1,1,2,106,59,0,0
Mike Matheson,PIT,D,59,8,12,20,-1,14,104,1,1,1,2,53,44,0,0
Michael Raffl,PHI,LW,58,8,12,20,-2,14,66,2,0,1,1,25,73,1,0
Christopher Tanev,CGY,D,69,2,18,20,4,41,45,1,0,1,1,159,32,0,1
Artem Anisimov,OTT,C,49,15,5,20,-15,8,87,1,5,1,6,25,6,0,0
Joel Edmundson,MTL,D,68,7,13,20,7,72,97,0,0,0,0,91,118,0,0
Radek Faksa,DAL,C,66,11,9,20,-6,42,109,3,3,0,3,44,84,0,0
Tyler Pitlick,ARI,C,63,8,12,20,11,12,76,1,0,0,0,42,132,0,0
Ryan Hartman,MIN,RW,69,9,11,20,4,69,114,1,1,0,1,54,44,0,0
Jimmy Vesey,TOR,LW,64,9,11,20,12,15,93,2,0,1,1,20,43,1,0
Milan Lucic,CGY,LW,68,8,12,20,-6,54,83,1,5,3,8,20,198,0,0
Nick Paul,OTT,LW,56,9,11,20,0,24,103,2,0,1,1,39,122,0,0
Anton Stralman,FLA,D,69,5,14,19,-6,14,89,3,0,0,0,96,68,0,1
Kyle Okposo,BUF,RW,52,9,10,19,-3,28,82,2,1,0,1,15,55,0,0
Connor Murphy,CHI,D,58,5,14,19,2,27,117,0,0,0,0,138,128,0,1
Zemgus Girgensons,BUF,LW,69,12,7,19,-1,10,85,1,0,0,0,20,110,1,0
Carter Rowney,ANA,C,71,8,11,19,5,14,63,1,0,0,0,42,189,2,2
Anders Bjork,BOS,LW,58,9,10,19,5,10,66,0,1,0,1,21,43,0,0
Brandon Carlo,BOS,D,67,4,15,19,16,33,111,0,0,0,0,76,126,0,0
TJ Brodie,TOR,D,64,4,15,19,7,36,65,1,0,1,1,87,20,0,0
Justin Braun,PHI,D,62,3,16,19,-2,18,70,0,0,1,1,84,91,0,0
Brad Hunt,MIN,D,59,8,11,19,-7,6,106,0,3,7,10,39,12,0,0
Josh Leivo,CGY,LW,36,7,12,19,0,4,69,0,0,5,5,8,17,0,0
Brett Howden,NYR,C,70,9,10,19,-11,28,64,2,1,1,2,67,69,0,2
William Carrier,VGK,LW,71,7,12,19,0,39,99,1,0,0,0,11,213,0,0
Matt Roy,LAK,D,70,4,14,18,16,10,112,0,0,1,1,100,132,0,0
Mark Pysyk,DAL,D,58,9,9,18,4,20,64,1,0,0,0,38,47,0,0
Mark Borowiecki,NSH,D,53,7,11,18,1,58,63,0,0,0,0,120,199,1,0
Brett Pesce,CAR,D,61,4,14,18,7,27,104,0,0,0,0,91,22,0,2
Cedric Paquette,CAR,C,61,7,11,18,-1,42,78,0,0,0,0,49,175,1,1
Justin Holl,TOR,D,68,2,16,18,13,43,89,0,0,0,0,83,89,0,0
Johan Larsson,ARI,LW,62,6,12,18,8,26,60,0,0,0,0,31,85,0,0
Brandon Montour,BUF,D,54,5,13,18,13,28,86,0,0,2,2,53,60,0,0
Oskar Lindblom,PHI,LW,30,11,7,18,4,4,72,0,3,1,4,16,31,0,0
MacKenzie Weegar,FLA,D,45,7,11,18,6,33,77,1,0,0,0,71,76,0,0
Vladislav Gavrikov,CBJ,D,69,5,13,18,1,18,81,1,0,0,0,92,79,0,0
P.K. Subban,NJD,D,68,7,11,18,-21,79,151,3,2,4,6,90,88,0,0
Brendan Lemieux,NYR,LW,59,6,12,18,-14,111,86,0,2,3,5,52,164,1,1
Marcus Sorensen,SJS,LW,66,7,11,18,-12,26,78,0,0,0,0,18,56,1,0
Michal Kempny,WSH,D,58,3,15,18,19,22,73,0,0,0,0,72,42,0,0
Kyle Clifford,STL,LW,69,7,10,17,-7,68,110,0,0,0,0,15,133,0,0
Alex Tuch,VGK,RW,42,8,9,17,-10,8,98,2,3,4,7,20,58,0,0
Brandon Sutter,VAN,C,44,8,9,17,1,25,76,0,1,2,3,15,18,0,0
Brock McGinn,CAR,LW,68,7,10,17,-4,17,93,1,0,0,0,28,80,2,0
Madison Bowey,CHI,D,53,3,14,17,-16,34,70,0,0,1,1,58,53,0,0
Troy Stecher,DET,D,69,5,12,17,10,32,86,0,0,0,0,70,69,0,0
Olli Maatta,LAK,D,65,4,13,17,0,20,80,0,0,0,0,110,119,0,2
Garnet Hathaway,WSH,RW,66,9,7,16,6,79,80,1,0,0,0,46,189,0,1
Mike Reilly,OTT,D,44,1,15,16,-6,24,85,1,1,8,9,46,39,0,1
Erik Johnson,COL,D,59,3,13,16,9,20,99,1,0,0,0,115,97,0,0
Michael Amadio,LAK,C,68,6,10,16,-11,10,99,0,0,3,3,22,21,0,0
Tucker Poolman,WPG,D,57,4,12,16,-1,24,64,1,0,0,0,59,58,1,0
Justin Faulk,STL,D,69,5,11,16,-3,32,147,1,1,2,3,76,82,0,1
David Kampf,CHI,C,70,8,8,16,-11,8,90,2,0,0,0,26,52,1,0
Blake Comeau,DAL,LW,55,8,8,16,-6,36,74,2,0,0,0,24,107,1,1
Dillon Dube,CGY,C,45,6,10,16,0,6,60,2,1,1,2,13,59,0,0
Philippe Myers,PHI,D,50,4,12,16,17,30,78,0,0,0,0,44,80,0,0
Ben Hutton,ANA,D,65,4,12,16,5,14,114,1,0,0,0,76,51,0,0
Alec Martinez,VGK,D,51,3,13,16,-4,23,75,0,0,4,4,117,43,0,0
Darren Helm,DET,LW,68,9,7,16,-6,37,102,0,0,0,0,26,88,1,1
Colton Sceviour,PIT,C,69,6,10,16,2,6,114,0,0,0,0,72,91,0,0
Tomas Nosek,VGK,LW,67,8,7,15,-2,20,93,1,0,0,0,38,91,1,0
Troy Terry,ANA,RW,47,4,11,15,-5,6,73,0,0,2,2,9,3,0,0
Mathieu Perreault,WPG,LW,49,7,8,15,-9,10,71,0,2,0,2,19,69,0,0
Jonathan Drouin,MTL,LW,27,7,8,15,-6,14,51,1,1,3,4,5,25,0,0
Radko Gudas,FLA,D,63,2,13,15,15,40,90,1,0,0,0,75,164,0,0
Riley Sheahan,BUF,C,66,8,7,15,-13,6,70,1,0,0,0,33,26,1,1
Michael Del Zotto,CBJ,D,49,2,13,15,5,14,57,0,0,1,1,55,101,0,0
Nic Dowd,WSH,C,56,7,8,15,11,28,52,1,0,0,0,26,117,3,0
Ryan Reaves,VGK,RW,71,8,7,15,-5,47,61,1,0,0,0,24,316,0,0
Henri Jokiharju,BUF,D,69,4,11,15,-6,32,78,0,1,1,2,63,74,0,0
Cody Eakin,BUF,C,49,5,10,15,-3,16,61,1,0,1,1,16,49,0,0
Drake Caggiula,ARI,C,40,9,6,15,-3,32,56,0,1,0,1,16,81,0,1
Marc-Edouard Vlasic,SJS,D,70,5,10,15,-10,10,74,1,0,0,0,97,37,1,0
Nate Thompson,WPG,C,70,4,11,15,-1,30,67,1,0,0,0,50,118,0,1
Pierre Engvall,TOR,LW,48,8,7,15,4,6,72,3,0,0,0,10,29,1,1
Ryan Carpenter,CHI,C,69,3,12,15,-6,28,80,0,0,0,0,48,117,1,2
Nicolas Aube-Kubel,PHI,RW,36,7,8,15,1,19,48,1,2,1,3,16,82,0,0
Colton Sissons,NSH,C,57,9,6,15,-2,20,52,2,0,0,0,41,84,1,0
Filip Zadina,DET,RW,28,8,7,15,-13,2,60,1,4,3,7,10,11,0,0
Andrew Cogliano,DAL,C,68,3,11,14,2,30,68,0,0,0,0,31,86,0,0
Haydn Fleury,CAR,D,45,4,10,14,-2,8,65,0,0,0,0,45,48,0,1
Leo Komarov,NYI,RW,48,4,10,14,2,10,46,1,0,0,0,29,123,0,1
Nick Holden,VGK,D,61,6,8,14,-1,13,101,0,1,0,1,74,129,0,1
Carson Soucy,MIN,D,55,7,7,14,16,18,61,1,0,0,0,50,69,1,0
Andy Greene,NYI,D,63,2,12,14,1,16,60,0,0,1,1,155,30,0,2
Ryan Lindgren,NYR,D,60,1,13,14,16,47,47,0,0,0,0,70,94,0,0
Casey Cizikas,NYI,C,48,10,4,14,12,41,67,1,0,0,0,39,133,3,2
Austin Watson,OTT,LW,53,6,8,14,-9,65,50,1,0,0,0,48,131,0,2
Zdeno Chara,WSH,D,68,5,9,14,26,60,86,2,0,0,0,101,78,0,0
Brenden Dillon,WSH,D,69,1,13,14,-2,104,58,0,0,0,0,74,194,0,1
Riley Nash,CBJ,C,64,5,9,14,6,10,64,1,0,0,0,36,68,1,0
Jordan Oesterle,ARI,D,58,3,10,13,-9,14,69,0,0,2,2,88,48,0,0
Loui Eriksson,VAN,LW,49,6,7,13,-2,12,59,0,0,0,0,15,10,0,0
Jake McCabe,BUF,D,66,3,10,13,-11,41,75,1,0,0,0,90,91,1,0
Victor Rask,MIN,C,43,5,8,13,7,6,38,2,0,0,0,8,26,0,0
Antoine Roussel,VAN,LW,41,7,6,13,0,43,55,1,1,1,2,14,44,0,0
Jordan Martinook,CAR,LW,45,2,11,13,-2,22,44,1,0,0,0,23,72,0,2
Zach Aston-Reese,PIT,C,57,6,7,13,6,28,98,0,0,0,0,30,136,1,0
Nicolas Deslauriers,ANA,LW,59,7,6,13,-1,92,64,1,0,0,0,32,137,0,0
Marco Scandella,STL,D,62,4,9,13,14,20,77,0,0,0,0,60,78,0,0
Carter Verhaeghe,FLA,C,52,9,4,13,-9,8,57,1,1,0,1,8,29,0,0
Sam Lafferty,PIT,C,50,6,7,13,5,23,56,1,0,0,0,17,95,0,0
Robert Hagg,PHI,D,49,3,10,13,14,30,38,0,1,0,1,79,136,0,0
Alexandre Texier,CBJ,C,36,6,7,13,3,10,49,1,0,1,1,7,20,0,0
Sam Gagner,DET,C,42,6,7,13,-10,12,79,0,2,1,3,10,22,0,0
Scott Mayfield,NYI,D,67,5,8,13,8,53,98,1,0,0,0,117,93,0,2
Adam Boqvist,CHI,D,41,4,9,13,-3,6,50,1,0,2,2,43,33,0,0
Sammy Blais,STL,LW,40,6,7,13,-2,20,56,1,0,0,0,15,155,0,0
Nikita Zadorov,CHI,D,64,4,9,13,6,65,65,0,0,0,0,66,175,0,0
Devin Shore,EDM,C,45,5,7,12,-10,8,50,1,0,2,2,14,52,0,0
Eric Robinson,CBJ,LW,50,7,5,12,10,12,69,3,0,0,0,15,79,0,0
Ryan McDonagh,TBL,D,50,1,11,12,7,19,50,0,0,0,0,101,36,0,1
Justin Schultz,WSH,D,46,3,9,12,-13,6,86,0,0,6,6,50,36,0,0
Trevor Lewis,WPG,C,56,6,6,12,-7,16,92,1,0,0,0,22,68,0,0
Sam Bennett,CGY,C,52,8,4,12,-1,36,82,0,0,1,1,13,101,0,0
Max Jones,ANA,LW,59,8,4,12,-6,36,102,0,0,1,1,18,82,1,0
Erik Cernak,TBL,D,67,5,7,12,11,59,125,1,0,0,0,97,172,0,0
Travis Hamonic,VAN,D,50,3,9,12,-3,27,83,0,0,0,0,110,39,0,0
Shayne Gostisbehere,PHI,D,42,5,7,12,-4,20,73,1,1,4,5,37,14,0,0
Nikita Zaitsev,OTT,D,58,1,11,12,-8,22,64,0,0,0,0,121,108,0,0
Cody Glass,VGK,C,39,5,7,12,-7,6,51,1,1,5,6,6,15,0,0
Johnny Boychuk,NYI,D,64,2,9,11,-11,14,96,0,1,0,1,128,135,0,0
Victor Mete,MTL,D,51,4,7,11,5,20,57,1,0,1,1,60,20,0,0
Jack Johnson,NYR,D,67,3,8,11,-1,26,63,0,0,0,0,97,183,1,0
Colin Miller,BUF,D,51,1,10,11,-9,22,79,1,0,3,3,40,87,0,0
Austin Wagner,LAK,LW,65,6,5,11,-5,39,124,0,0,0,0,19,145,0,0
Max Comtois,ANA,LW,29,5,6,11,-4,24,32,0,2,1,3,8,61,0,0
Travis Dermott,TOR,D,56,4,7,11,14,37,65,1,0,0,0,58,76,0,0
Nicolas Hague,VGK,D,38,1,10,11,0,32,54,0,1,3,4,26,69,0,0
Zack Smith,CHI,C,50,4,7,11,2,29,43,1,0,0,0,18,112,1,1
David Savard,CBJ,D,68,0,11,11,-3,35,97,0,0,2,2,163,129,0,0
Brad Richardson,NSH,RW,59,6,5,11,1,20,76,3,0,0,0,44,77,1,1
Jacob Larsson,ANA,D,60,2,9,11,-9,12,58,0,0,0,0,57,34,0,0
Mario Ferraro,SJS,D,61,2,9,11,-15,30,63,0,0,0,0,58,120,0,1
Dylan Gambrell,SJS,C,50,5,6,11,-8,17,43,1,0,1,1,29,40,0,0
Jason Demers,ARI,D,50,0,11,11,5,25,53,0,0,0,0,70,76,0,1
Dante Fabbro,NSH,D,64,5,6,11,-7,38,92,0,1,0,1,85,54,0,0
Marc Staal,DET,D,52,2,9,11,5,16,46,0,0,0,0,76,69,0,0
Trevor Moore,LAK,C,42,6,4,10,-4,6,60,0,0,0,0,17,60,0,1
Evan Rodrigues,PIT,C,45,6,4,10,-8,14,75,1,1,0,1,15,24,0,0
Michael Dal Colle,NYI,LW,53,4,6,10,-8,12,59,0,0,0,0,21,81,0,0
Slater Koekkoek,EDM,D,42,1,9,10,3,42,47,1,0,0,0,58,64,0,0
Jayce Hawryluk,VAN,C,26,3,7,10,1,16,26,0,0,0,0,9,65,0,0
Jujhar Khaira,EDM,LW,64,6,4,10,-19,38,69,1,0,0,0,30,136,0,0
Tobias Rieder,BUF,LW,55,4,6,10,-12,6,77,0,0,0,0,26,30,1,1
Chris Wagner,BOS,RW,67,6,4,10,-8,47,78,0,0,0,0,31,192,1,0
Kevin Stenlund,CBJ,C,32,6,4,10,2,8,57,1,3,2,5,22,19,0,0
Dylan DeMelo,WPG,D,59,0,10,10,4,37,74,0,0,0,0,77,105,0,2
Adam Lowry,WPG,C,49,4,6,10,-4,23,68,1,0,0,0,22,137,1,1
Jamie Oleksiak,DAL,D,69,3,7,10,-6,41,76,1,0,0,0,59,153,0,0
Colin Blackwell,NYR,C,27,3,7,10,7,10,31,0,0,0,0,23,43,0,0
Travis Boyd,TOR,C,24,3,7,10,9,2,26,0,0,1,1,9,14,0,0
Paul Byron,MTL,LW,29,4,6,10,5,4,29,0,0,0,0,18,42,1,0
Gaetan Haas,EDM,C,58,5,5,10,-1,6,54,0,0,1,1,28,58,0,0
Drake Batherson,OTT,RW,23,3,7,10,-12,13,32,0,1,5,6,11,51,0,0
Dmitry Kulikov,NJD,D,51,2,8,10,-4,32,54,1,0,0,0,77,104,0,0
Luca Sbisa,NSH,D,44,2,8,10,1,37,49,0,0,0,0,71,91,0,0
Mackenzie MacEachern,STL,LW,51,7,3,10,2,33,63,2,0,0,0,13,82,0,0
Nicolas Roy,VGK,C,28,5,5,10,3,8,42,1,1,0,1,7,39,0,0
Andrew Shaw,CHI,RW,26,3,7,10,-4,33,46,0,1,1,2,9,74,0,0
Jonas Siegenthaler,WSH,D,64,2,7,9,11,43,49,1,0,0,0,105,51,0,0
Josh Manson,ANA,D,50,1,8,9,-10,37,64,0,0,0,0,65,113,0,1
Jordan Kyrou,STL,C,28,4,5,9,1,8,39,0,0,1,1,8,8,0,0
Adam Pelech,NYI,D,38,1,8,9,4,20,49,0,0,0,0,83,81,0,2
Jacob de la Rose,STL,LW,50,2,7,9,2,10,46,0,0,0,0,16,120,0,0
Christian Fischer,ARI,RW,56,6,3,9,2,16,83,1,0,0,0,22,140,0,0
Joakim Nygard,EDM,LW,33,3,6,9,0,8,39,0,1,0,1,8,18,0,0
Taylor Fedun,DAL,D,27,2,7,9,3,8,40,0,0,0,0,19,16,0,0
Brayden McNabb,VGK,D,71,2,7,9,1,40,73,0,0,0,0,133,201,1,0
Kris Russell,EDM,D,55,0,9,9,0,14,45,0,0,0,0,101,71,0,1
Markus Nutivaara,FLA,D,37,3,6,9,2,4,47,0,0,1,1,33,35,0,0
Stefan Noesen,SJS,RW,40,7,2,9,-1,32,67,2,1,0,1,17,74,0,0
Luke Glendening,DET,C,60,6,3,9,-29,14,76,1,0,0,0,68,147,1,0
Ryan Murray,NJD,D,27,2,7,9,-9,4,32,0,0,2,2,50,12,0,0
Radim Simek,SJS,D,48,2,7,9,-13,14,40,0,0,0,0,60,91,0,0
Patrik Nemeth,DET,D,64,1,8,9,-10,28,89,1,0,0,0,92,80,0,1
Erik Gudbranson,OTT,D,51,4,5,9,0,95,78,0,0,0,0,58,89,0,1
Frans Nielsen,DET,C,60,4,5,9,-13,8,86,0,0,2,2,35,44,1,1
Casey Mittelstadt,BUF,C,31,4,5,9,-5,2,34,1,1,1,2,8,11,0,0
Kevin Rooney,NYR,C,49,4,5,9,8,20,59,0,0,0,0,32,64,2,1
Caleb Jones,EDM,D,43,4,5,9,-1,10,38,1,0,1,1,46,33,0,0
Jay Beagle,VAN,C,55,2,6,8,-9,38,49,1,0,0,0,42,69,1,1
Matt Benning,NSH,D,43,1,7,8,8,15,38,0,0,0,0,34,78,0,0
Tyler Motte,VAN,C,34,4,4,8,-10,10,38,0,0,0,0,37,118,0,0
Rasmus Sandin,TOR,D,28,1,7,8,-7,10,22,1,0,2,2,22,33,0,0
Andrej Sekera,DAL,D,57,2,6,8,9,14,63,0,0,0,0,75,34,1,0
Mason Appleton,WPG,C,46,5,3,8,-9,20,55,0,0,0,0,12,20,1,0
Brendan Smith,NYR,D,62,3,5,8,-12,71,45,0,0,0,0,41,90,1,1
Cody Ceci,PIT,D,56,1,7,8,7,20,48,1,0,0,0,79,92,0,0
Matt Martin,NYI,LW,55,5,3,8,-1,40,49,2,0,0,0,24,242,0,0
Martin Frk,LAK,RW,17,6,2,8,-1,4,26,1,1,0,1,3,14,0,0
Kurtis MacDermid,LAK,D,45,3,5,8,-9,47,51,0,0,0,0,43,95,0,1
Brian Dumoulin,PIT,D,28,1,7,8,17,10,35,0,0,1,1,35,44,1,0
Bobby Ryan,DET,RW,24,5,3,8,3,22,43,0,0,0,0,13,41,0,0
Josh Brown,OTT,D,56,3,5,8,1,39,48,1,0,0,0,53,77,0,0
Scott Harrington,CBJ,D,39,1,7,8,-3,16,37,0,0,0,0,48,46,0,0
Nick Jensen,WSH,D,68,0,8,8,1,13,61,0,0,1,1,71,59,0,0
Jesperi Kotkaniemi,MTL,C,36,6,2,8,-11,23,55,0,1,1,2,16,51,0,0
Trevor van Riemsdyk,WSH,D,49,1,7,8,-7,10,58,0,0,0,0,37,21,0,0
Nathan Beaulieu,WPG,D,38,1,7,8,15,29,38,1,0,0,0,47,62,0,0
Cal Clutterbuck,NYI,RW,37,3,4,7,6,22,35,0,0,0,0,38,127,1,1
Jansen Harkins,WPG,C,29,2,5,7,-2,5,29,0,0,0,0,10,8,0,0
Noah Dobson,NYI,D,34,1,6,7,-1,8,37,0,0,1,1,31,25,0,0
Mathieu Joseph,TBL,RW,37,4,3,7,-2,16,35,0,0,0,0,10,47,0,1
Zach Bogosian,TOR,D,27,1,6,7,0,22,29,0,0,0,0,27,30,0,1
Jan Rutta,TBL,D,33,1,6,7,6,14,43,0,0,0,0,21,19,0,0
Brett Kulak,MTL,D,56,0,7,7,-1,12,101,0,0,0,0,50,59,0,0
Mark Jankowski,PIT,C,56,5,2,7,-12,14,38,0,0,0,0,33,14,0,0
Carl Gunnarsson,STL,D,36,2,5,7,8,16,31,0,0,0,0,51,27,0,1
Juuso Riikola,PIT,D,36,1,6,7,3,6,38,0,0,2,2,24,74,0,0
Jordie Benn,VAN,D,44,1,6,7,-7,17,58,1,0,0,0,62,45,0,0
Morgan Frost,PHI,C,20,2,5,7,-3,4,31,0,0,0,0,4,4,1,0
Jon Merrill,DET,D,49,2,5,7,9,32,37,0,0,0,0,71,51,0,1
Oliver Kylington,CGY,D,48,2,5,7,-6,16,37,0,0,0,0,34,36,0,0
Gabriel Vilardi,LAK,C,10,3,4,7,0,4,19,0,1,1,2,4,1,0,0
Joakim Nordstrom,CGY,C,48,4,3,7,-6,17,49,0,0,0,0,31,91,0,0
Adam Larsson,EDM,D,49,1,5,6,0,35,61,0,0,0,0,82,112,0,0
Filip Chlapik,OTT,C,31,3,3,6,-7,10,27,1,0,0,0,11,71,0,0
Calvin de Haan,CHI,D,29,1,5,6,10,10,42,0,0,0,0,73,93,0,0
Connor Carrick,NJD,D,29,1,5,6,-6,17,25,1,0,0,0,39,27,0,0
Mitchell Stephens,TBL,C,38,3,3,6,-9,10,43,0,0,0,0,9,36,0,0
Justin Dowling,DAL,C,29,3,3,6,-3,8,29,1,0,0,0,12,25,0,0
Yakov Trenin,NSH,C,21,2,4,6,1,9,25,0,0,0,0,9,46,0,0
Matthew Highmore,CHI,C,36,2,4,6,-1,6,35,0,0,0,0,9,38,0,0
Chad Ruhwedel,PIT,D,41,2,4,6,4,12,44,0,0,0,0,25,74,0,0
Robert Bortuzzo,STL,D,42,2,4,6,12,21,36,1,0,0,0,43,66,0,0
Brett Ritchie,CGY,RW,27,2,4,6,-3,21,34,1,0,1,1,3,89,0,0
Zack MacEwen,VAN,C,17,5,1,6,6,20,17,0,0,0,0,5,41,0,0
Adam Erne,DET,LW,56,2,3,5,-24,28,63,0,0,0,0,25,142,0,0
Sami Niku,WPG,D,17,0,5,5,-2,12,27,0,0,0,0,19,16,0,0
Bryan Little,WPG,C,7,2,3,5,4,2,13,1,0,0,0,3,3,0,0
Niklas Hjalmarsson,ARI,D,27,1,4,5,-2,14,18,0,0,0,0,46,20,0,1
Zac Rinaldo,CGY,C,19,3,2,5,-1,34,19,2,0,0,0,8,69,0,0
Dean Kukan,CBJ,D,33,1,4,5,-9,12,51,0,1,0,1,28,24,0,0
Patrick Russell,EDM,RW,45,0,5,5,-11,12,58,0,0,0,0,25,64,0,0
Jarred Tinordi,NSH,D,28,1,4,5,-1,34,20,0,0,0,0,36,71,0,1
Matt Luff,LAK,RW,18,1,4,5,-5,2,25,0,0,0,0,5,16,0,0
Ville Heinola,WPG,D,8,1,4,5,3,4,10,0,0,1,1,5,3,0,0
Stephen Johns,DAL,D,17,2,3,5,0,10,30,0,0,0,0,20,50,0,0
Josh Anderson,MTL,RW,26,1,3,4,-8,17,63,0,0,0,0,13,68,0,0
Carl Grundstrom,LAK,RW,13,0,4,4,2,8,16,0,0,0,0,4,29,0,0
John Hayden,ARI,C,43,3,1,4,-2,77,39,1,0,0,0,27,87,0,0
Ross Johnston,NYI,LW,32,3,1,4,1,78,16,0,0,0,0,14,93,0,0
Phillip Di Giuseppe,NYR,LW,20,1,3,4,1,2,35,0,0,0,0,20,38,0,0
Ilya Lyubushkin,ARI,D,51,0,4,4,4,18,41,0,0,0,0,53,151,0,0
Erik Brannstrom,OTT,D,31,0,4,4,-9,16,38,0,0,1,1,36,15,0,0
Brent Seabrook,CHI,D,32,3,1,4,1,8,40,1,1,0,1,61,52,0,0
Barrett Hayton,ARI,C,20,1,3,4,2,14,27,1,0,0,0,3,14,0,0
Isac Lundestrom,ANA,C,15,0,4,4,-2,0,10,0,0,1,1,8,5,0,0
Dakota Mermis,MIN,D,10,1,3,4,7,4,17,0,0,0,0,21,20,0,0
Jesper Boqvist,NJD,C,35,4,0,4,-11,8,41,0,1,0,1,16,37,0,0
Rasmus Asplund,BUF,C,29,1,2,3,-4,6,36,0,0,0,0,7,20,0,1
Matt Tennyson,NJD,D,20,0,3,3,-2,6,14,0,0,0,0,18,27,0,0
Andrew Peeke,CBJ,D,22,1,2,3,1,4,23,0,0,0,0,21,25,0,0
Dennis Gilbert,COL,D,21,1,2,3,-8,38,12,0,0,0,0,33,74,0,0
Christian Djoos,DET,D,11,1,2,3,3,0,13,0,0,1,1,12,2,0,0
Luke Schenn,TBL,D,25,1,2,3,-8,23,31,0,0,0,0,21,83,0,0
John Moore,BOS,D,24,2,1,3,-2,11,33,0,0,0,0,27,36,0,0
Stefan Matteau,CBJ,C,9,2,1,3,0,5,18,0,0,0,0,10,27,0,0
Jake Evans,MTL,C,13,2,1,3,1,0,14,0,0,0,0,5,16,0,0
Rudolfs Balcers,SJS,LW,15,1,2,3,-2,0,23,1,0,0,0,7,19,0,0
Matt Irwin,BUF,D,36,0,3,3,-15,15,58,0,0,0,0,54,80,0,0
Yannick Weber,PIT,D,41,1,2,3,-1,14,45,1,0,0,0,38,37,0,0
Julien Gauthier,NYR,RW,17,0,3,3,1,8,10,0,0,0,0,7,15,0,0
Connor Bunnaman,PHI,C,21,1,1,2,7,2,18,0,0,0,0,2,29,0,0
Nick Bjugstad,MIN,C,13,1,1,2,3,8,18,0,0,0,0,7,19,0,0
Fredrik Claesson,SJS,D,5,1,1,2,1,0,1,0,0,0,0,7,5,0,0
Jacob Middleton,SJS,D,10,0,2,2,-2,9,9,0,0,0,0,5,18,0,0
Gerald Mayhew,MIN,C,13,2,0,2,4,2,16,0,0,0,0,6,11,0,0
Daniel Sprong,WSH,RW,8,1,1,2,-2,0,17,0,1,0,1,3,4,0,0
Brandon Pirri,CHI,C,16,0,2,2,-4,8,24,0,0,0,0,5,16,0,0
Joel Hanley,DAL,D,8,0,2,2,0,6,4,0,0,0,0,8,3,0,0
Michael McLeod,NJD,C,12,0,2,2,4,4,11,0,0,0,0,6,19,0,0
Matthew Peca,OTT,C,14,0,2,2,-4,0,7,0,0,0,0,4,15,0,0
Tomas Jurco,VGK,RW,12,0,2,2,1,4,7,0,0,0,0,3,4,0,0
Connor Clifton,BOS,D,31,2,0,2,4,12,20,0,0,0,0,33,90,0,0
Jeremy Lauzon,BOS,D,19,1,1,2,5,29,20,0,0,0,0,23,32,0,0
Nico Sturm,MIN,C,6,0,2,2,2,0,2,0,0,0,0,5,6,0,0
Logan O'Connor,COL,RW,16,2,0,2,0,2,15,1,0,0,0,8,20,0,0
Nicholas Merkley,NJD,RW,4,1,1,2,0,2,8,0,0,0,0,2,9,0,0
Kyle Capobianco,ARI,D,9,1,0,1,-1,2,10,0,0,0,0,10,14,0,0
Jordan Gross,ARI,D,2,0,1,1,2,0,3,0,0,0,0,1,0,0,0
Gemel Smith,TBL,C,3,1,0,1,0,4,1,0,0,0,0,2,1,0,0
Kiefer Sherwood,COL,LW,10,0,1,1,-1,6,17,0,0,0,0,4,24,0,0
Lias Andersson,LAK,C,17,0,1,1,-8,4,13,0,0,0,0,8,20,0,0
Micheal Haley,OTT,LW,22,1,0,1,-7,50,9,0,0,0,0,6,36,0,0
Alexander Volkov,TBL,RW,9,0,1,1,-6,6,7,0,0,0,0,2,10,0,0
Miikka Salomaki,COL,RW,5,1,0,1,2,4,2,1,0,0,0,3,9,0,0
T.J. Tynan,COL,C,16,0,1,1,-1,2,7,0,0,0,0,3,7,0,0
Buddy Robinson,CGY,RW,5,1,0,1,0,7,6,0,0,0,0,5,14,0,0
Derek Forbort,WPG,D,20,0,1,1,-5,4,22,0,0,0,0,30,35,0,0
Daniel Carr,WSH,LW,11,1,0,1,-5,4,14,0,0,0,0,2,10,0,0
Jani Hakanpaa,ANA,D,5,1,0,1,1,2,4,0,0,0,0,7,15,0,0
Zach Whitecloud,VGK,D,16,0,1,1,3,4,9,0,0,0,0,16,10,0,0
Mathieu Olivier,NSH,RW,8,0,1,1,1,4,6,0,0,0,0,1,17,0,0
Anthony Angello,PIT,C,8,1,0,1,-1,4,5,0,0,0,0,5,13,0,0
Niko Mikkola,STL,D,5,0,1,1,3,0,10,0,0,0,0,3,5,0,0
Mikey Anderson,LAK,D,6,1,0,1,4,0,9,1,0,0,0,10,10,0,0
Eetu Luostarinen,FLA,C,8,0,1,1,-2,0,9,0,0,0,0,2,9,0,0
Jason Robertson,DAL,LW,3,0,1,1,0,0,4,0,0,1,1,0,1,0,0
Mason Marchment,FLA,LW,4,0,1,1,0,0,3,0,0,0,0,0,3,0,0
Joel Kiviranta,DAL,LW,11,1,0,1,-1,4,13,0,0,0,0,3,17,0,0
Mark Friedman,PHI,D,6,0,1,1,0,2,2,0,0,0,0,5,8,0,0
Lucas Carlsson,CHI,D,6,0,1,1,3,0,3,0,0,0,0,6,11,0,0
Luke Johnson,MIN,C,3,0,0,0,-3,0,1,0,0,0,0,0,6,0,0
Oliver Wahlstrom,NYI,RW,9,0,0,0,-2,4,9,0,0,0,0,4,10,0,0
Janne Kuokkanen,NJD,LW,1,0,0,0,0,0,0,0,0,0,0,0,3,0,0
Keegan Kolesar,VGK,RW,1,0,0,0,0,0,1,0,0,0,0,0,2,0,0
Michael Sgarbossa,WSH,C,2,0,0,0,0,0,1,0,0,0,0,0,3,0,0
Josh Norris,OTT,C,3,0,0,0,2,0,9,0,0,0,0,2,3,0,0
Christian Wolanin,OTT,D,3,0,0,0,1,0,4,0,0,0,0,4,0,0,0
Jayson Megna,COL,C,8,0,0,0,-1,2,4,0,0,0,0,5,10,0,0
Alexandre Carrier,NSH,D,3,0,0,0,2,2,4,0,0,0,0,0,3,0,0
Kevin Connauton,FLA,D,4,0,0,0,-2,0,4,0,0,0,0,6,6,0,0
Brandon Hagel,CHI,LW,1,0,0,0,0,0,4,0,0,0,0,1,1,0,0
Nicolas Beaudin,CHI,D,1,0,0,0,1,0,2,0,0,0,0,2,2,0,0
Conor Timmins,COL,D,2,0,0,0,2,0,1,0,0,0,0,0,0,0,0
Kale Clague,LAK,D,4,0,0,0,-3,2,2,0,0,0,0,4,1,0,0
Jaret Anderson-Dolan,LAK,C,4,0,0,0,-1,0,2,0,0,0,0,0,3,0,0
Tobias Bjornfot,LAK,D,3,0,0,0,-4,0,0,0,0,0,0,0,0,0,0
Nikolai Knyzhov,SJS,D,3,0,0,0,-1,2,0,0,0,0,0,4,4,0,0
Sheldon Dries,COL,C,5,0,0,0,-2,0,2,0,0,0,0,2,16,0,0
Tage Thompson,BUF,RW,1,0,0,0,0,0,0,0,0,0,0,0,2,0,0
Steven Fogarty,BUF,C,7,0,0,0,-1,0,2,0,0,0,0,4,4,0,0
Brandon Davidson,BUF,D,12,0,0,0,-3,0,17,0,0,0,0,20,24,0,0
William Lagesson,EDM,D,8,0,0,0,-4,0,8,0,0,0,0,12,4,0,0
Justin Bailey,VAN,RW,2,0,0,0,0,0,1,0,0,0,0,0,4,0,0
